to	~쪽으로, ~에게
ever	언젠가, 이제까지
she	그녀
too	~도 또한
scientific	과학적인
night	밤
mind	마음
along	~을 따라
air	공기
keep	간직하다
power	힘
rather	오히려
then	그때
side	측면
ability	능력
teacher	선생님
present	현재, 선물
three	셋
children	어린이들
consider	고려하다
city	도시
but	그러나
he	그
decide	결심하다
home	가정
their	그들의
men	man(남자)의 복수형
on	~위에
such	그러한
parents	부모님
pass	통과하다
four	넷
young	젊은
play	놀다
woman	여자
five	다섯
world	세계
thousand	천 (1000)
feel	느끼다
sound	소리
number	수
watch	지켜보다
have	가지다
view	전망
two	둘
think	생각하다
still	아직도
free	자유로운
soon	곧
bring	가져오다
letter	글자
stand	서다
most	가장 큰
man	남자
accept	받아들이다
given	give(주다)의 과거분사
off	떨어져
seen	see(보다)의 과거 분사
a	하나의
course	진로, 과정
therefore	그러므로
freedom	자유
very	대단히
out	밖에
little	작은
believe	믿다
full	가득한
some	어떤
together	함께
activity	활동
group	집단
exist	존재하다
back	뒤, 되돌아와서
are	~이다
begin	시작되다
allow	허락하다
country	나라
school	학교
purpose	목적
college	단과대학
which	어느 것
use	이용하다
real	진실의
seem	~으로 보이다
much	다량의
you	당신(들)
opinion	의견
different	다른
find	찾아내다
follow	따라가다
let	~하게 하다
into	~안으로
eye	눈
wish	바라다
me	나를
book	책
thing	것
matter	문제
one	하나
American	미국의, 미국인
always	항상
knowledge	지식
idea	생각
modern	현대의
house	집
over	~위에
walk	걷다
would	will의 과거형
small	작은
town	마을
near	가까이
future	미래
help	돕다
same	같은
return	돌려주다
away	떨어져서
work	일하다
example	예
who	누구
leave	남기다
system	체계
yet	아직
almost	거의
case	경우
and	~와, 그리고
new	새로운
I	나
its	그것의
far	먼
next	다음의
give	주다
today	오늘
business	사업
upon	위로
face	얼굴
sometimes	가끔
or	혹은
food	식품
car	차
easy	쉬운
create	창조하다
road	길
if	만약 ~라면
what	무엇
control	제어하다
word	낱말
England	잉글랜드
week	일주일
left	왼쪽
hour	시간
nature	자연
big	큰
picture	그림
is	be의 3인칭 단수 현재형(~이다)
start	출발하다
taken	take(잡다, 받다)의 과거분사
was	be의 1, 3인칭 단수 과거형(~였다)
order	명령(하다)
hope	바라다, 희망하다
after	~후에
get	얻다
though	비록 ~한다 할지라도
enjoy	즐기다
room	방
point	점
also	~도 또한
how	어떻게
appear	나타나다
my	나의
short	짧은
art	예술
call	부르다
head	머리
hand	손
travel	여행하다
more	더 많은
try	시도하다
live	살다
need	필요하다
we	우리
deal	다루다
individual	개인, 개인적인
moment	순간
for	~을 위해
however	그러나
poor	가난한
lie	눕다
public	공중의
us	우리를, 우리에게
other	다른
concern	~에 관계하다
thought	think(생각하다)의 과거/ 과거분사형
read	읽다
know	알다
great	거대한, 대단한
want	~을 원하다
so	그래서
Korea	한국
change	바꾸다
day	하루, 날
difference	차이점
carry	나르다, 운반하다
while	~하는 동안
both	둘 다
earth	지구
last	맨 마지막의
pleasure	기쁨
state	상태
never	결코 ~하지 않다
around	주위에
age	나이
discover	발견하다
than	~보다
many	많은
force	힘
heart	심장
science	과학
among	~의 사이에
question	질문
learn	~을 배우다
feeling	감정
with	~와(함께)
in	안에
end	끝, 마지막
society	사회
come	오다
language	언어
her	그녀의
trouble	문제점, 괴로움, 곤란
best	가장 좋은
sure	틀림없는
produce	생산하다
place	장소
child	어린이, 아이
cause	~의 원인이 되다, 초래하다
there	그 곳에, 거기
anything	무엇이든
reason	이유
run	달리다
social	사회적인
could	can(할 수 있다)의 과거형
year	1년, 해
life	생명
general	일반적인
ago	~전에
hard	어려운
open	열다
against	~에 반대하여
long	긴
our	우리의
important	중요한
right	옳은
develop	개발하다, 발전하다
really	정말
machine	기계
able	~할 수 있는
value	가치
close	닫다
all	모든
subject	주제
possible	가능한
like	좋아하다
own	자기 자신의
itself	그것 자체
enough	충분한
writer	작가
when	언제
train	기차
culture	문화
money	돈
put	놓다
become	~이 되다
later	나중에
hear	듣다
will	~할 것이다
die	죽다
land	땅
please	기쁘게 하다
common	공통의, 보통의
up	위로
without	~없이
job	일, 직업
remember	기억하다
natural	자연의
why	왜
happen	발생하다
certain	확신하는
perhaps	아마
at	~에
form	모양, 형태
stop	멈추다
probably	아마
grow	자라다, 기르다
education	교육
his	그의, 그의 것
century	세기, 100년
talk	이야기하다
part	일부, 부분
America	미국
usually	평소에는, 보통
speak	이야기하다
expert	전문가
few	거의 없는
it	그것
well	잘
death	사망, 죽음
say	말하다
people	사람들
law	법
may	~일지도 모르다
him	그를
they	그들
often	종종
progress	발전, 진행되다
answer	대답(하다)
development	발전, 발달
particular	특별한
set	놓다, 배치하다
water	물
time	시간
move	움직이다
turn	돌다
this	이것
problem	문제
high	높은
sense	감각
old	오래된, 늙은
during	~동안
whole	전부의
even	~조차
go	가다
did	do(하다)의 과거형
study	공부하다
do	하다
person	사람
look	보다
early	일찍이, 이른
about	~에 대하여
now	지금
just	다만
of	~의
again	다시
must	~해야 한다
toward	~쪽으로
body	몸
tell	말하다
each	각각의
human	인간
use	쓰다, 사용하다
family	가족
only	유일한, 단지
reach	도달하다
your	당신(들)의
under	~의 아래에
girl	소녀
fact	사실
something	어떤 것
Korean	한국인, 한국의
story	이야기
class	학급, 반
make	만들다
themselves	그들 자신
half	절반
down	아래로
every	모든, 매 ~마다
the	그
indeed	정말로, 실제로
himself	그 자신
whether	~인지 어떤지, ~든지 아니든지
can	~할 수 있다
morning	아침
mean	의미하다
understand	이해하다
another	다른 하나의
difficult	어려운
remain	남다, 여전히 ~이다
once	한 번
hundred	100
better	더 좋은
second	두 번째
past	과거, 지나간
less	더 적은
write	쓰다
where	어디(로, 에서)
way	길
result	결과
university	대학교
nation	국가
nothing	없는 것, 아무 것도 ~없다
love	사랑(하다)
here	여기
history	역사
through	~을 통하여
dream	꿈(을 꾸다)
that	저것
necessary	필요한
first	첫 번째의
from	~로부터
least	가장 작은, 가장 적은(little의 최상급)
kind	친절한
any	어떤, 무엇이든, 누구든
receive	받다
large	큰
myself	나 자신
ask	묻다
since	~이래로
name	이름
show	보여주다
father	아버지
see	보다
war	전쟁
boy	소년
light	빛
animal	동물
take	가지고 가다, 받다
everything	모든 것
student	학생
English	영어
friend	친구
quite	상당히, 꽤
until	~까지
lose	잃다
continue	계속하다
mother	어머니
increase	증가하다
between	~(둘) 사이에
before	~ 이전에
process	과정
instance	보기, 경우
thus	그러므로
sit	앉다
success	성공
single	단 하나의, 독신의
window	창문
everyone	모두 다
wait	기다리다
outside	외부, 밖의
choose	선택하다
yourself	당신 자신
generation	세대
behind	~의 뒤에
million	백만
village	마을
serious	진지한, 심각한
line	선, 줄
belief	신념
likely	~할 것 같은
rule	규칙
explain	설명하다
game	경기
stay	머무르다
accident	사고
paper	종이
beautiful	아름다운
suffer	~을 겪다
advantage	유리한 점, 이득
radio	라디오
creature	창조물
six	여섯
action	행동
offer	제공하다
door	문
build	세우다, 건설하다
fast	빠른, 빨리
population	인구
several	몇몇의
sight	광경
importance	중요성
various	여러 가지의
practice	연습하다
act	행동하다
company	회사
writing	쓰기
manner	예절
main	주요한
educate	교육하다
visit	방문하다
object	사물, 목적
tree	나무
eat	먹다
lack	결핍, 부족한
event	행사
limit	한계
rate	비율
television	텔레비전
easily	쉽게
measure	측정하다, 치수를 재다
physical	육체의, 신체의
space	공간
share	나누다, 분배하다
practical	실용적인, 실제의
music	음악
listen	듣다
kill	죽이다
standard	표준, 기준
pick	찍다, 줍다
popular	인기 있는
simply	간단히
merely	단지
rain	비, 비가 오다
personal	개인의, 개인적인
average	평균
mental	정신적인
recognize	인정하다, 알아보다
simple	간단한
agree	동의하다
step	걸음
white	흰, 하얀색
moon	달
doubt	의심하다
Greek	그리스 사람(의)
fellow	동료
garden	정원
street	거리
Europe	유럽
across	가로질러, 맞은편에
surprise	놀라게 하다
private	사적인
buy	사다
habit	습관
special	특별한
ten	열(10)
danger	위험
noise	소음
piece	조각, 한 개
energy	에너지
someone	누군가
yes	네(긍정의 대답)
arrive	도착하다
doctor	의사
prevent	막다, 방지하다
attitude	태도
meaning	의미
mass	대중, 집단, 큰 덩어리
information	정보
sort	종류
except	~을 제외하고는
labor	노동
respect	존경하다
satisfy	만족시키다
acquire	얻다
whose	누구의
add	더하다
literature	문학
advance	진보, 전진
ground	땅, 토지
chance	기회
bed	침대
stage	무대
situation	상황
late	늦은
save	구하다
cold	추운
service	봉사
mile	마일
stone	돌
suppose	가정하다
anyone	누군가, 누구라도
gone	go(가다)의 과거분사형
behavior	행동, 태도
career	직업
philosophy	철학
nearly	거의
fine	좋은
lay	놓다, 두다, 눕히다
degree	정도
attention	주의
poetry	시
truth	진실
month	한 달
British	영국
sea	바다
environment	환경
ancient	고대의
prefer	~을 더 좋아하다
sun	태양
worth	가치
brother	형제
unless	만일 ~이 아니면
fire	불
clear	맑은, 명백한
ordinary	보통의
tend	~하는 경향이 있다
low	낮은
son	아들
method	방법
front	앞, 정면
existence	존재
pay	지불하다
judge	재판관
blood	피
already	이미, 벌써
notice	주의, 알아채다
bad	나쁜
condition	상태
ourselves	우리들 자신
worker	노동자
foreign	외국의
provide	공급하다, 제공하다
newspaper	신문
area	지역
color	색
suggest	제안하다
instead	그 대신에
particularly	특히
artist	예술가
discovery	발견
library	도서관
rich	부유한
member	회원
beyond	~의 저편에
effect	효과
impossible	불가능한
wife	아내
effort	노력
opportunity	기회
exactly	정확하게
industry	산업
difficulty	어려움
economic	경제의
movement	운동, 활동, 움직임
communication	통신, 정보(의사) 교환
universe	우주
reader	독자
demand	요구하다
surface	표면
mark	표시(하다)
care	걱정, 주의, 돌봄
hardly	거의 ~않다
choice	선택
break	부수다
afraid	두려워하여
wrong	잘못된, 틀린
taste	맛
spirit	정신, 마음, 영혼
fail	실패하다
sleep	잠자다
southern	남쪽의
river	강
cover	덮다
alone	홀로
rest	휴식, 쉬다
happy	행복한
hold	손에 들다
certainly	확실히
twenty	스물(20)
government	정부
material	물질
strong	강한
lead	인도하다, 이끌고 가다
position	위치, 자세
interested	흥미를 가진
teach	가르치다
forward	앞으로
else	그 밖에
United States	미합중국
fall	떨어지다
relation	관계
bird	새
beauty	아름다움
interesting	흥미있는
attempt	시도(하다)
speech	연설
minute	분
imagine	상상하다
require	필요로 하다
star	별
none	아무(것)도 ~않다
occur	일어나다, 발생하다
fear	공포
flower	꽃
suddenly	갑자기
wonder	의아하게 여기다, 놀라다
complete	완성하다
record	기록(하다)
prove	증명하다
voice	목소리
generally	일반적으로
plan	계획(하다)
spend	쓰다, 소비하다
enter	~에 들어가다
scientist	과학자
determine	결정하다
either	어느 한 쪽의
neighbor	이웃 사람
finally	마침내
quality	질, 품질
express	표현하다
meet	만나다
period	기간
field	들판, 벌판
third	세 번째의, 제3의
weather	날씨
extent	넓이
complex	복잡한
institution	제도, 협회
Chinese	중국의, 중국인, 중국어
horse	말
wild	야생의
sky	하늘
depend	~에 의존하다
growth	성장
curiosity	호기심
amount	총계, 양
sign	기호, 신호, 간판
automobile	자동차
heavy	무거운
search	찾다
achievement	성취
moral	도덕의
factor	요소
figure	모습, 인물
experiment	실험
possess	소유하다
decision	결심
slow	느린
mountain	산
journey	여행
warm	따뜻한
supply	공급하다
perfect	완전한
shape	모양
sister	자매
office	사무소
support	지탱하다
race	경주
appreciate	감사하다
smoke	연기
familiar	익숙한
beginning	처음, 시작
direction	방향
fill	채우다
hurry	서두르다
opposite	반대의
adventure	모험
democracy	민주주의
normal	보통의, 표준의
equal	같은, 평등한
article	(신문) 기사, 물품
similar	유사한
frequently	자주
cross	십자가, ~을 가로지르다
afternoon	오후
invention	발명
contribute	~을 기증하다, 공헌하다
citizen	시민
draw	당기다, (그림을) 그리다
childhood	유년기
direct	똑바른, 직접의
establish	~을 설립하다
largely	주로, 대부분, 크게
god	신
leisure	여가
content	만족한, 만족하여
fly	날다
summer	여름
suit	(정장) 한 벌
herself	그녀 자신
black	검은
promise	약속(하다)
ideal	이상적인
prepare	준비하다
famous	유명한
busy	바쁜
collect	~을 모으다, 수집하다
succeed	성공하다
maintain	~을 유지하다
news	뉴스
master	주인
youth	젊은이, 청년
escape	도망하다, 탈출하다
rise	뜨다, 오르다
immediately	즉시
communicate	의사소통하다
evil	나쁜, 악
spring	봄
dress	의복, 정장
assure	보증하다, 확신시키다
speed	속력
entirely	완전히
memory	기억력
separate	~을 분리하다
everybody	모두, 누구나 다
admit	~을 인정하다
patient	참을성 있는
breathe	호흡하다
recent	최근의
baby	갓난아이
atmosphere	환경, 분위기
emotion	감정, 정서
essential	필수적인
earn	일하여 벌다
possibility	가능성
necessity	필요(성)
include	~을 포함하다
obvious	명백한
function	기능, 작용
conduct	행위, 행동하다
abroad	해외로
ready	준비된
apple	사과
strange	이상한, 낯선
due	지불기일이 된
pound	(무게)파운드
account	설명하다
seek	~을 찾다, 추구하다
German	독일의, 독일인, 독일어
useful	쓸모 있는, 유용한
level	수준, 정도
occasion	경우, 특별한 일
interpret	해석하다
completely	완전히, 철저히
surround	~을 둘러싸다, 에워싸다
seat	좌석, 자리
approach	~에 접근하다, 다가가다
west	서쪽(의)
majority	대다수
reply	대답하다
brain	뇌
telephone	전화
author	작가, 저자
path	작은 길, 오솔길
affect	~에 영향을 미치다
evening	저녁
happiness	행복
cut	자르다
above	~보다 위에
intelligent	지적인
drop	떨어지다, ~을 떨어뜨리다
compare	(둘을) 비교하다
mouth	입
manage	~을 관리[경영]하다
note	(짧은) 기록, 적어두다
observe	~을 관찰하다
theory	이론
image	이미지, 형태
describe	묘사하다
impression	인상
island	섬
discussion	의논, 토론
wide	폭이 넓은
laugh	웃다
variety	다양성
bit	작은 조각
height	높이
center	중심
bear	(아이를) 낳다, ~을 견디다
vast	거대한, 막대한
price	값, 가격
comfort	~을 위로하다
Britain	영국
principle	원리, 원칙
income	수입, 소득
audience	청중
cease	그치다, ~을 중지하다
thank	감사하다
community	공동체, 지역사회
personality	개성, 성격
mere	단순한, 단지 ~에 불과한
avoid	~을 피하다
soul	영혼, 정신, 마음
rock	바위
quickly	빨리
holiday	휴일
involve	포함하다
disease	병, 질병
survive	~에서 살아남다
fight	싸우다, 전투하다
comfortable	편안한
clothes	옷, 의복
store	가게, 상점
wind	바람
nobody	아무도 ~않다
touch	손을 대다, 만지다
admire	감탄하다
concentrate	집중하다
crowd	군중, 다수
base	토대, 기초, 근거
source	원천, 근원
western	서쪽의
recently	최근에, 요즘에
station	역, 정거장
courage	용기
conscious	의식하고 있는
enable	~할 수 있게 하다
round	둥근
conversation	회화, 대화
bury	~을 묻다
mankind	인류
drink	마시다
fish	물고기
structure	구조
tongue	혀
achieve	~을 성취하다
drive	운전하다
circumstance	상황, 환경
successful	성공한
reveal	~을 드러내다, 밝히다
party	파티, 모임
duty	의무
exercise	운동(하다), 연습(하다)
husband	남편
ocean	대양
quiet	조용한
constant	지속적인, 불변의
pattern	형, 양식
actually	실제로
cost	비용이 들다
apply	적용하다, 신청하다
differ	다르다
dear	친애하는
deep	깊은
church	교회
capacity	수용력, 정원
settle	정착하다
plant	식물, (식물을) 심다
middle	한가운데의
highly	높이, 대단히
raise	~을 올리다
marry	~와 결혼하다
imagination	상상
pain	아픔, 고통
Englishman	영국인
mistress	주부, 여주인
judgement	판단, 평가
dead	죽은
cry	울다
finish	~을 끝내다
destroy	~을 파괴하다
sport	스포츠
cat	고양이
living	생계, 생활
national	국민의, 국가의
instrument	도구
basic	기초의, 근본적인
ancestor	조상, 선조
wood	목재, 숲
scholar	학자
clearly	명확히, 확실히
dark	어두운
French	프랑스인, 프랑스의, 프랑스어
liberty	자유
tradition	전통
breath	숨, 호흡
daily	매일의
fit	~에 꼭 맞다, 적합하다
table	테이블, 탁자
European	유럽(사람)의
religion	종교
human being	인류
affair	사건
wear	입고[쓰고, 신고] 있다
distance	거리
poet	시인
lecture	강의
heat	열
industrial	산업의
native	출생지의, 타고난
authority	권위
aim	목적, 목표삼다
according	~에 따라서
forget	~을 잊다
mistake	잘못, 실수
strength	힘
constantly	끊임없이
neither	~도 아니고
dog	개
further	더 멀리, 더욱이
gain	~을 얻다
task	일, 직무
dry	마른, 물기 없는
alive	살아 있는
attack	~을 공격하다
architecture	건축술
health	건강
slowly	느리게
blind	눈 먼
anybody	누군가
insist	주장하다
excite	흥분시키다
coat	코트, 외투
tool	도구
product	생산품
hot	더운
truly	진실로
sweat	땀, 땀흘리다
guide	안내자, 안내하다
anxious	걱정하는, 열망하여
observation	관찰, 관측
instinct	본능
civilize	문명화하다
France	프랑스
spot	장소, 지점
send	~을 보내다
democratic	민주정치의
reduce	줄이다, 감소시키다
examination	시험
yesterday	어제
apart	떨어져서
motion	운동, 움직임
perfectly	완전히, 완벽하게
policeman	경찰관
gift	선물
seize	~을 붙잡다, 꽉 잡다
belong	속하다, 소유물이다
post	기둥
explanation	설명
extremely	극단적으로
wonderful	놀랄 만한, 경이적인
humanity	인류, 인간성
contain	~을 포함하다, 담고 있다
dinner	정찬, 만찬
trust	신임, 신뢰하다
pretty	예쁜, 꽤
bus	버스
paint	그리다
satisfactory	만족스러운
attach	~을 붙이다
pull	잡아당기다
pleasant	기분 좋은, 즐거운
intelligence	지능, 지성
mechanism	기계(류)
daughter	딸
size	크기
contrary	반대의
occupy	~을 잡다, 차지하다
ill	병든, 아픈
powerful	강력한
conflict	투쟁, 충돌
delight	기쁨, 즐거움
pretend	~인 체하다
floor	마루, 층
immediate	즉시의, 직접의
hunt	사냥하다
solve	(문제 등을) 풀다
claim	요구하다
devote	바치다, 쏟다
traffic	교통
percent	퍼센트, 백분율
balance	균형
original	최초의, 원래의
loose	느슨한, 헐거운
persuade	설득하다
professional	전문적인
represent	나타내다, 표현하다
pioneer	개척자
contemporary	현대의, 같은 시대의
proportion	비율
insect	곤충
being	존재, 실재
proper	적당한
responsibility	책임
basis	기초
corner	모퉁이
railroad	철도
fully	충분히
valuable	귀중한
active	활발한
reasonable	논리적인, 합리적인
refuse	거절하다
improvement	개선, 향상
technique	기법, 기교
closely	접근하여, 밀접하게
enjoyment	즐거움
technical	기술적인
loss	잃음, 손실
dangerous	위험한
wake	잠을 깨다
curious	호기심이 강한
plain	명백한, 평이한
wall	벽
weight	무게
behave	행동하다
extend	~을 뻗다, 연장하다
dollar	달러
tea	차
huge	거대한
wise	슬기로운, 현명한
reflect	반사하다
magazine	잡지
boat	보트
discuss	~을 논의하다
appeal	호소하다, 간청하다
stream	흐름
refer	언급하다
excitement	흥분, 자극
secure	안전한
skill	숙련, 기술
statement	진술
arrange	정돈하다, 배치하다
weapon	무기
foreigner	외국인
element	요소
necessarily	반드시
gather	모으다
equally	동등하게, 같게
treat	다루다, 취급하다
aid	돕다, 거들다
relatively	상대적으로
consist	~으로 이루어지다
peace	평화
engineer	기사, 기술자
appearance	외관, 생김새
fashion	유행
contact	접촉(하다)
photograph	사진
unable	할 수 없는
wisdom	지혜
smooth	매끄러운
worry	걱정하다
building	건물
sufficient	충분한
driver	운전사
superior	우수한
prejudice	편견
joy	기쁨
encourage	용기를 북돋다
vary	바뀌다, 변화하다
bee	꿀벌
tall	키가 큰
illness	병
complicate	복잡하게 하다
smile	미소짓다
blue	푸른
major	주요한
replace	~을 대신하다
contrast	대조
detail	상세한 설명
guess	추측하다
available	이용할 수 있는
protect	보호하다
region	지방
argument	논쟁
dictionary	사전
climate	기후
research	연구
evidence	증거
theater	극장
novel	소설
faculty	재능
tendency	경향
surely	확실히
adult	어른
reality	현실
repeat	되풀이하다
ahead	앞에, 앞쪽에
shop	상점
bound	경계(선)
consequence	결과
manager	지배인
arm	팔
primitive	원시의, 옛날의
ear	귀
lady	여자, 부인
blow	(바람이) 불다, 불어대다
aware	알고 있는
capable	능력이 있는
origin	기원, 유래
snow	눈
horizon	지평선
peculiar	이상한, 특이한
mention	말하다
enemy	적
intend	~할 작정이다
broad	넓은
fruit	과일
threat	협박
miss	놓치다, 그리워하다
owner	소유자
trip	여행
farm	농장
nice	좋은, 친절한
artificial	인공의
planet	행성
visitor	방문자
scene	장면
shock	충격(을 주다)
technology	과학기술
bright	밝은
cultural	교양적인, 문화적인
anxiety	걱정, 근심
rapidly	신속하게, 재빠르게
slight	근소한, 하찮은
king	왕
confidence	신임, 자신
chief	최고의
forest	숲
define	정의를 내리다
afford	~할 여유가 있다
spread	펴다, 펼치다
careful	주의 깊은
attend	~에 출석하다
significance	중요성
naturally	자연히
serve	~을 섬기다
philosopher	철학자
winter	겨울
worthy	가치 있는
compose	구성하다, 조직하다
obviously	명백하게
desert	사막
absorb	흡수하다
hair	머리카락, 털
microscope	현미경
test	시험, 검사하다
species	종
hat	모자
medium	중간, 보통의
aspect	면, 양상, 관점
ship	배
property	재산
grant	승인하다, 인정하다
publish	출판하다
bow	허리를 굽히다, 절하다
failure	실패
improve	개선하다, 향상하다
spent	spend(쓰다)의 과거/ 과거분사형
report	보도하다
feature	특징, 용모
gentleman	신사
seldom	좀처럼 ~하지 않다
season	계절
carefully	주의 깊게
connection	관계, 연계
fault	결점, 잘못
enterprise	기업
widely	넓게, 크게
sentence	문장
engage	약속하다
neglect	무시하다, 소홀히 하다
ignorance	무지
monkey	원숭이
partly	부분적으로
struggle	발버둥치다, 애쓰다
advice	충고
secret	비밀
range	범위
flood	홍수
admirable	훌륭한, 감탄할 만한
green	녹색
east	동쪽
professor	교수
tomb	무덤
leg	다리
bank	은행
organize	조직하다
trade	장사, 무역
safe	안전한
rough	거친
catch	붙잡다
international	국제적인
painting	그림 (그리기)
politics	정치
revolution	혁명
convince	확신시키다
feed	먹을 것을 주다
former	이전의
shoulder	어깨
disappear	사라지다
waste	낭비하다
praise	칭찬(하다)
local	지방의
stranger	낯선 사람
criticism	비평
examine	검사하다, 시험하다
discipline	훈련
relationship	관계
mine	나의 것
climb	오르다
greatly	크게, 몹시
top	정상, 꼭대기
educational	교육상의
gradually	서서히, 차츰
police	경찰
sell	팔다
dozen	다스(12개)
adequate	알맞은
tragedy	비극
significant	중요한, 의미있는
flow	흐르다
pet	애완동물
adapt	~을 적응시키다
alter	변경하다, 바꾸다
program	프로그램
production	생산
tough	질긴, 끈기 있는
apparently	명백하게
destruction	파괴
current	현재의
interval	간격
worst	가장 나쁜
custom	풍습, 관습
owe	빚지고 있다, ~의 덕택으로 알다
muscle	근육
accurate	정확한
military	육군의
copy	사본
agriculture	농업
skin	피부
quarrel	말다툼, 싸우다
friendly	친한, 정다운
previous	이전의
date	날짜
exception	예외
effective	효과적인
permit	허가하다
pronounce	발음하다
coal	석탄
adopt	채택하다, 양자로 삼다
resistance	저항
decade	10년간
nose	코
emotional	감정적인
anger	화, 노여움
jump	도약, 뛰어오르다
critical	비평의, 비판적인
honor	명예
employ	고용하다
tear	찢다
conclusion	결말
weigh	무게를 달다, 무게가 ~나가다
coast	해안
vocabulary	어휘
background	배경
roll	구르다, 굴러가다
presence	존재, 출석
demonstrate	증명하다, 설명하다
below	~보다 아래에
hurt	상처를 입히다
endeavor	노력
comb	빗
graduate	졸업하다
altogether	전적으로, 완전히
count	세다
shoe	구두
aunt	아주머니
remove	옮기다, 제거하다
beat	치다, 때리다
deny	부정하다
economy	경제
ignore	무시하다
honest	정직한
argue	논쟁하다
bridge	다리
creation	창조
independence	독립
notion	개념
length	길이
advise	충고하다
acquaintance	아는 사람
beside	~의 곁에
favor	호의
angry	노한, 화난
thinking	생각, 의견
nevertheless	그럼에도 불구하고
protest	항의하다
defeat	쳐부수다, 패배시키다
nineteenth	제 19의, 19일
command	명령하다
cloud	구름
independent	독립한
fresh	신선한
win	이기다
charge	책임, 의무
oneself	자기 자신
proud	자랑스러운
somehow	어떻게 해서든지
relative	상대적인, 친척
quick	빠른, 신속한
rapid	재빠른, 민첩한
speaker	말하는 사람
directly	직접, 곧장
properly	적당하게
vague	막연한, 모호한
lesson	학과, 수업
map	지도
deeply	깊게
sail	돛, 항해하다
disappoint	실망시키다
biography	전기, 일대기
goal	목표, 결승점
cheap	(값이) 싼
soil	흙, 토질
chair	의자
push	밀다
possession	소유
inside	안쪽
actor	남자 배우
silence	침묵
exchange	교환하다
rush	돌진하다, 서두르다
address	주소
dislike	싫어하다
fix	수리하다, 고정시키다
unknown	알려지지 않은
square	네모진 것, 광장
message	메시지, 전갈
privilege	특권
whereas	그러나 (사실은), ~에 반(反)하여
virtue	선, 미덕
hotel	호텔
rarely	드물게
hesitate	주저하다
dignity	위엄
resource	자원
straight	똑바른
landscape	경치, 풍경
poverty	빈곤
narrow	좁은
sing	노래하다
spiritual	정신적인, 영적인
per	~마다
scarcely	거의 ~않다
historian	역사가
lake	호수
ease	편함, 안락
genuine	진짜의
glance	힐끗 보다
resist	저항하다
check	조사하다, 점검하다
mood	기분
indicate	가리키다, 지적하다
park	공원
alike	서로 같은
ours	우리의 것
cast	던지다
hill	작은 산, 언덕
satisfaction	만족
tomorrow	내일
moreover	게다가, 더욱이
bosom	가슴, 흉부
wash	씻다
sir	선생, 님, 씨
series	일련, 연속
laughter	웃음, 웃음소리
preserve	보존하다
blame	나무라다, 책망하다
actual	현실의, 사실상의
exhibit	전시[전람]하다
box	상자
soldier	군인
training	훈련
shadow	그림자
weak	약한
ambition	야심, 야망
glass	유리
excellent	우수한, 뛰어난
scale	저울, 규모
somewhat	약간, 다소
painter	화가
remarkable	두드러진, 눈에 띌 만한
sorry	미안하게 생각하는, 유감스러운
last	계속하다, 지속하다
healthy	건강에 좋은
breakfast	아침밥
arise	일어나다, 발생하다
press	누르다
sew	꿰매다
manufacture	제조[하다]
reference	언급, 참조
estimate	어림잡다, 견적
everywhere	도처에
self	자기, 자신
meal	식사
orchestra	관현악단
clean	청결한
furniture	가구
medieval	중세의
twice	두 번
Africa	아프리카
fox	여우
pronunciation	발음
invent	발명하다
expensive	값비싼
excuse	용서하다, 변명하다
fundamental	근본적인
hit	치다
efficient	능률적인, 효과가 있는
grass	풀, 잔디
definite	명확한
desk	책상
join	참가하다
style	스타일, 종류, 형
remind	생각나게 하다
minority	소수
Germany	독일
introduce	소개하다
branch	가지
sudden	갑작스러운
pour	붓다
hero	영웅
benefit	이익
apparent	명백한
marriage	결혼
pride	자랑, 자존심
will	의지
hostility	적의, 적개심
ride	타다
fairly	공정히, 공평히
laboratory	실험실
throw	던지다
cool	서늘한
page	페이지
circle	원
whenever	~할 때마다
poem	시
obtain	얻다, 획득하다
principal	주요한
thoroughly	철저히
lawyer	법률가
empty	빈, 공허한
tourist	여행자
noble	고귀한
male	남성
medicine	약
hospital	병원
volume	권, 부피
pear	배
fair	공정한
sugar	설탕
exhaust	다 써버리다, 소모하다
couple	한 쌍
perform	실행하다, 연기(연주)하다
sick	병 난, 앓는
pupil	학생, 눈동자
remark	주의하다, 말하다
computer	컴퓨터
operation	작동
guard	지키다
enthusiasm	열정
universal	우주의
heaven	하늘, 천국
design	디자인(하다), 설계하다
wealth	부, 재산
divide	나누다
China	중국
literary	읽고 쓸 줄 앎, 지식, 능력
evolution	진화
official	공무원
addition	추가, 부가
birth	출생
brow	눈썹, 이마
vision	시력
till	~까지
tired	피로한
stick	막대기
profession	직업
individuality	개성, 인격
absence	부재, 결석
firm	견고한, 확고한
fatigue	피로
wander	떠돌아 다니다
constitute	구성하다
talent	재능
traditional	전통적인
prosperity	번영
extraordinary	비상한, 색다른
Asia	아시아
distinction	구별, 차이
south	남쪽
stretch	쭉 펴다, 뻗치다
wound	상처, 부상(하게 하다)
organization	조직
intellect	지력, 지성
red	빨강
Spanish	스페인 (사람)의, 스페인어
typical	전형적인
connect	~을 잇다, 연결하다
worship	숭배, 숭배하다
sensitive	예민한
symbol	상징
bread	빵
slave	노예
confine	한정하다
crow	까마귀
film	필름
issue	논점
appropriate	적당한
tone	어조, 말씨
yours	당신의 것
steak	스테이크
territory	영토
imply	의미하다
crop	수확하다
tour	여행
slightly	약간
magic	마법
print	인쇄하다
perceive	인지하다, 알아차리다
routine	일상적인
row	줄
movie	영화
interpreter	통역사
occupation	직업
entire	전체의
afterward	후에
transform	변형시키다
arrival	도착
suggestion	제안
decent	깔끔한, 품위있는
latter	후자의
cell	세포
consideration	고려, 고찰
passage	통행, 통로
alarm	놀라게 하다, 경보를 내다
relief	안도, 안심
dull	흐릿한, 우둔한
clothing	의복
orbit	궤도
fool	바보
astonish	놀라게 하다
temperature	온도, 기온
confuse	혼란시키다
shelter	대피소
autumn	가을
display	전시하다, 진열하다
suspect	의심하다
bomb	폭탄
lazy	게으른
assumption	가정, 전제
possibly	아마, 혹시
teaching	가르침
wholly	온통, 완전히
justice	정의
farmer	농부
sorrow	슬픔, 비애
somewhere	어딘가에
swim	수영하다
application	적용
fond	좋아하여, 마음에 들어
differently	다르게
calendar	달력
Indian	인도인, 인디언
handle	다루다, 처리하다
exact	정확한
manuscript	원고
tie	~를 묶다, 매다
beard	턱수염
inhabit	~에 살다, 거주하다
injure	상처를 입히다
beneath	~의 바로 밑에
justify	정당화하다
risk	위험
repair	수리하다
organism	유기체
security	안전
wave	물결, 파도
increasingly	점점 더, 더욱 더
primarily	본질적으로, 주로
device	장치, 기구
comment	주석, 해설
battle	전투
abandon	버리다, 떠나다
historical	역사의, 역사상의
violent	폭력적인, 난폭한
considerable	상당한, 적지 않은
cough	기침하다
kitchen	부엌
imitate	모방하다, 흉내내다
dawn	새벽
finger	손가락
accomplish	성취하다
warn	경고하다
fulfill	실행하다, 수행하다
absurd	터무니없는, 부조리한
yard	뜰
expectation	기대
invite	초대하다
solution	해결
consequently	따라서, 그 결과로서
response	응답, 대답
distribute	분배하다
heir	상속인, 후계자
advertise	광고하다
occurrence	발생
superficial	표면의, 외면의, 피상적인
description	묘사, 설명
indifferent	무관심한
reflection	반사
profit	이익, 수익
Roman	로마의, 로마인의
stomach	위, 배
competition	경쟁
oppose	반대하다, 반항하다
wherever	어떤 곳에든지
milk	우유
pair	한 쌍, 두 개
distant	먼, 멀리 있는
polite	공손한
mathematics	수학
savage	야만적인, 잔인한
biological	생물학의
cottage	오두막집
cousin	사촌
welfare	행복, 복지
dust	먼지
May	5월
Sunday	일요일
burn	타다, 태우다
infant	유아
prospect	전망, 가망
India	인도
inherit	상속하다
inadequate	부적당한, 불충분한
cent	센트
efficiency	능률, 효율
association	연합
comparable	~와 비교할 수 있는
high school	고등학교
pen	펜
raw	날것의, 가공하지 않은
tremendous	대단한, 굉장한
absolute	절대적인
cultivate	경작하다
despite	~에도 불구하고
substitute	~를 대신하다
enormous	거대한
plow	쟁기
firmly	단단히, 확고하게
critic	비평가
precisely	정확하게
pursuit	추적, 추구
proceed	나아가다, 전진하다, 계속하다
voyage	여행, 항해
rose	장미
specialize	(~을) 전문으로 하다
meeting	모임, 회의
steal	~을 훔치다
academic	학문의
sweet	달콤한
reward	보상
impulse	충동
recover	회복하다
convey	~를 운반하다, 나르다
butterfly	나비
card	카드
stress	강조, 중점
peasant	소작인, 농민
accompany	~에 동반하다
harm	해, 손상, 손해
thorough	완전한, 철저한
artistic	예술적인
reign	통치하다
anywhere	어디에서나
overcome	~을 이겨내다, 극복하다
analysis	분석
extreme	극단의
complain	불평하다
idle	게으른, 무익한
Italian	이탈리아인
key	열쇠
treasure	보물
besides	~이외에도
tiny	몹시 작은
glove	장갑
fortune	운수, 큰 재산
conquer	정복하다, 이기다
renaissance	르네상스
commit	(죄, 과실 등을) 저지르다
wage	임금, 급여
leader	지도자
definition	정의함, 명확하게 함
regret	~를 후회하다
coffee	커피
operate	(기계 등을) 작동하다
plough	쟁기
bottom	아랫부분, 바닥
suitable	적당한
meat	고기
minimum	최소한의, 최저의
lion	사자
machinery	기계(류)
expose	~를 드러내다
unusual	이상한, 유별난
pocket	호주머니
pure	순수한, 불순물이 없는
receipt	영수증
ultimately	결국
headache	두통
slip	미끄러지다
era	시대
painful	아픈, 괴로운
ball	공
edge	가장자리, 끝
bell	종
participate	참가하다, 가담하다
performance	실행, 연주, 공연
encounter	우연히 마주치다, 해후하다
sacrifice	희생
laborious	힘이 드는, 곤란한
clock	괘종시계
musical	음악의
brief	잠시의, 간결한
nurse	간호사
derive	~에서 얻다, 이끌어내다
melancholy	우울, 애수
violence	폭력
role	역할
bathe	목욕하다, ~를 목욕시키다
collection	수집
everyday	날마다의, 매일의
terrible	무시무시한, 형편없는
otherwise	만약 그렇지 않으면
sharply	날카롭게
stair	(~s) 계단
regular	규칙적인, 정연한
lonely	고독한
camel	낙타
market	시장
shout	외치다
motor	모터, 원동기
luxury	사치, 호사
frequent	빈번한
correct	올바른
stir	(액체 등을) 휘젓다
sympathy	동정, 연민
shut	~를 닫다
interrupt	방해하다
unite	결합하다
phrase	어구, 문구
attribute	특징, 특성
unhappy	불행한
plane	평면
servant	하인
purchase	구매하다
severe	엄격한
beg	간청하다
tower	탑
stamp	도장
architect	건축가
soft	부드러운
infamous	불명예스러운
drown	물에 빠져 죽다
ice	얼음
threaten	위협하다
strike	~를 치다
management	경영
hall	회관
urge	~를 다그치다, 재촉하다
inhabitant	주민
govern	(나라 등을) 다스리다
incline	기울이다
responsible	책임이 있는
pressure	압력
ring	반지
companion	동료, 친구
aloud	소리내어
rare	드문
bough	(나뭇) 가지
bowl	사발
attraction	끌어당기는 힘, 매력
peaceful	평화로운
seriously	심각하게
recreation	기분 전환, 레크리에이션
willing	기꺼이~하는
cook	요리하다
asleep	잠들어
nowadays	요즘에는
glad	기쁜
thief	도둑
creative	창조적인
gaze	가만히 보다, 응시하다
darkness	어둠
policy	정책
arrow	화살
forth	앞으로
conscience	양심
beach	해변
fun	재미, 즐거움
genius	천재
guest	손님
northern	북쪽의
spell	~의 철자를 말하다
medical	의학의
north	북쪽
dance	춤추다
frighten	놀라게 하다
mystery	신비
wool	양모, 양털
palace	궁전
hate	싫어하다
essentially	본질적으로
continent	대륙
identify	확인하다, 식별하다
sword	검, 칼
affection	애정
formal	정식의, 형식적인
farther	더 멀리
Russian	러시아인
metal	금속
concentration	집중
employment	고용
cloth	천
destiny	운명
bath	목욕
Italy	이탈리아
mysterious	신비한
foundation	기반, 토대
negative	부정적인
nest	(새의) 둥지
extra	여분의
barometer	지표
recommend	~를 추천하다
propose	제의하다, 제안하다
uncle	삼촌, 아저씨
lift	~를 들어올리다
apt	~하기 쉬운
tragic	비극의, 비통한
hungry	배고픈
defend	~를 방어하다
misery	불행
oblige	(남에게) 강요하다
sweater	스웨터
endure	견디다
elaborate	정교한, 공들여 만든
vain	헛된
perfection	완전
deceive	~를 속이다
cigarette	담배
borrow	빌리다
flat	평평한
egg	계란
hole	구멍
realm	영역, 범위
journal	(일간)신문
female	여성, 여성의
grief	슬픔
bicycle	자전거
opening	개시, 시작
commonly	일반적으로
percentage	백분율, 퍼센트
grasp	~를 꽉 쥐다
strive	노력하다, 애쓰다
adjust	조정하다, 맞추다
song	노래
cake	케이크
tear	눈물
rent	집세, 임대료
consciousness	의식
financial	재정의
thin	얇은
theoretical	이론상의
rid	~를 없애다
central	중심의
suburb	교외
cruel	잔인한
incident	사건
inspire	고취하다, 고무하다
journalist	신문기자
fancy	공상
airplane	비행기
disadvantage	단점, 불리한 점
counter	반대의
intention	의도, 의향
sum	합계
safety	안전
victim	희생자
silent	조용한
entertainment	연예
label	상표, 꼬리표
evident	명백한
mischief	손해
sale	판매
passenger	승객
conceive	생각해내다
utter	말하다
delay	지연시키다
hostile	적의가 있는
clerk	점원
construction	건설, 건축 공사
proof	증거
inheritance	유산, 상속
somebody	어떤 사람
stare	빤히 보다
hatred	증오
root	뿌리
comparison	비교
commerce	상업
final	최후의
fence	울타리, 담
steadily	꾸준히
foul	불결한
conventional	관습의, 틀에 박힌
investigation	조사
obedience	복종
pace	속도, 보조
total	총계
hence	그러므로
route	길
beast	짐승
board	널빤지, 판자
block	큰 덩어리
rice	쌀
precious	귀중한
acquaint	숙지시키다, 알리다
announce	공고하다, 발표하다
football	미식축구
inspiration	영감
decline	거절하다
inform	알리다
umbrella	우산
museum	박물관
translate	번역하다
technological	과학기술의
disaster	재난
essay	수필
import	수입하다
select	고르다
pause	중지, 중단
domestic	가정의, 국내의
probable	있을법한
electricity	전기
desirable	바람직한
convenience	편리
flesh	살, 고기
crisis	위기
compete	경쟁하다
endless	끝없는
physics	물리학
instruction	교육
immense	거대한, 매우 큰
indispensable	없어서는 안 되는
fate	운명, 숙명
absolutely	절대로
thick	두꺼운
conception	개념
brilliant	빛나는
wheel	바퀴
vacation	휴가
invitation	초대
amusement	오락
salt	소금
combine	~를 결합하다
impose	(벌금, 의무 등을) 부과하다
objective	객관적인
hasten	서두르다
arrangement	배열, 정리
edition	(간행물의) 판
sentiment	감정
Russia	러시아
infinite	무한의
crew	(비행기, 열차 등의) 승무원
list	목록
fiction	소설
tide	조수, 조류
toy	장난감
expert	전문가
project	계획하다
bottle	병
gray	회색
patience	인내
conclude	결론을 내리다
lovely	아름다운
quietly	조용히
gun	총
recall	회상하다
badly	좋지 않게, 심하게
fortunate	운좋은
respond	응답하다, 대답하다
anyway	아무튼
kindness	친절
double	2배의
interfere	간섭하다, 방해하다
endow	기부하다, 부여하다
expedition	탐험, 원정
mouse	쥐
essence	본질
survival	생존
unpleasant	불쾌한
match	성냥, 경기
carriage	사륜마차
passion	정열
unconscious	의식하지 못하는
foolish	어리석은
capital	수도
electric	전기의
ultimate	최종의, 궁극의
fade	희미해지다, 약해지다
mutual	서로의, 상호간의
arouse	깨우다
deliberate	심사숙고하다
numerous	수많은
strongly	강하게
impress	(남에게) 감동을 주다
vehicle	차량, 탈것
associate	교제하다, 제휴하다
challenge	도전
shore	바닷가, 강가
clever	영리한
brave	용감한
physically	물리적으로, 신체적으로
screen	스크린, 칸막이
gas	기체, 가스
bare	벌거벗은
calm	평온한
atomic	원자의
gold	금, 황금
abstract	추상적인
unique	유일한, 고유한
alternative	대안
specific	명확한, 구체적인
amuse	(남을) 즐겁게 하다
sigh	한숨쉬다
bother	괴롭히다
effectively	효과적으로
valley	계곡
Eskimo	에스키모 사람
prison	교도소
army	육군
exaggerate	과장하다
stupid	어리석은
handicap	신체 장애, 불리한 조건
diminish	감소하다
frog	개구리
survey	조사하다
stimulate	자극하다, 격려하다
release	(의무, 고통 등에서) 풀어주다
brown	갈색
taxi	택시
equality	평등
lunch	점심
elevator	승강기
compel	강요하다
minor	소수의, 중요하지 않은
engine	엔진, 발동기
iron	철, 쇠
obstacle	장애물
harmony	조화, 화합
geometry	기하학
dare	감히~하다
friendship	우정
bore	(사람을) 싫증나게 하다, 지루하게 하다
concept	개념, 관념
chew	씹다
barber	이발사
automatic	자동적인
strain	~를 잡아당기다
popularity	유행, 인기
geography	지리학
expand	~를 확대하다
long	긴
quantity	양, 분량
travel	여행하다
victory	승리
nonsense	허튼 소리, 터무니없는 일
attract	(주의, 흥미 등을) 끌다
funny	재미있는
measurement	측량, 계량
coach	~를 지도하다
isolate	격리시키다
educator	교육가
sex	성
composition	조립, 구성
orange	오렌지
prosperous	번영하는
Pacific	태평양
mad	미친, 화가 난
wet	젖은
positive	긍정적인
ignorant	무식한
confusion	혼란
debt	빚
steady	안정된, 일정한
originally	원래는
burden	짐
disturb	방해하다
sour	(음식물이) 신
banana	바나나
folk	사람들
attain	~을 달성하다
unfortunately	불행히도
aside	곁에, 옆으로
neighbor	이웃 (사람)
dirty	더러운
inquire	(남에게) 묻다, 문의하다
distinct	명료한, 뚜렷한
flock	떼, 무리
giant	거인
resort	휴양지
ashamed	부끄러워하여
accustomed	익숙한
eventually	결국
ruin	~를 파괴하다
lucky	운이 좋은
punish	~를 벌하다, 처벌하다
neck	목
flight	비행
reject	거절하다
loud	(소리, 음성이) 큰
damage	손해, 손상
noisy	시끄러운
sphere	구, 둥근 물체
alcohol	알콜
conceal	~를 숨기다
secretary	비서
net	그물, 망
skilled	숙련된
absent	불참한
staff	직원
guarantee	보증하다
dependent	의존하는, 의지하는
render	~이 되게하다
cup	컵
item	항목, 조항
committee	위원회
Englishman	영국인
purse	지갑
mechanics	역학, 기계학
pollution	오염
thinker	사상가
explore	탐험하다
Christmas	성탄절
title	제목
charm	매력
maybe	아마도
legal	합법적인, 법률의
limitation	제한
intense	강렬한
photography	사진촬영(술)
brush	솔, 솔질
industrious	근면한
injury	부상, 손상
grammar	문법
construct	구성하다, 건설하다
simplicity	단순성
villager	마을사람
pity	연민
precise	정확한
temper	기질
irritate	~를 화나게 하다
scream	비명을 지르다
textbook	교과서
butcher	정육점 주인
unlike	~와는 다르게
float	(액체 등에) 떠오르다, 떠다니다
sidewalk	보도, 인도
phenomena	phenomenon(현상)의 복수형
knock	(문 등을) 두드리다
continuous	끊임없는
proposal	제안, 제의
considerably	상당히
radical	근본적인
shave	깎다, 면도하다
humor	유머, 해학
lifetime	일생
parish	교구
cave	동굴
diameter	직경, 지름
elsewhere	다른 곳에서
restaurant	식당
intimately	친밀하게
old-fashioned	구식의
convenient	편리한
yellow	노란색
freely	자유롭게
elder	손위의
temporary	일시적인
tale	이야기
burst	터지다, 파열하다
railroad	철도
Latin	라틴어의
spectator	관객
mechanical	기계의, 기계적인
household	가족, 세대
delicate	섬세한
illustrate	설명하다
lock	자물쇠
reserve	따로 남겨두다, 보존하다
luck	운, 운수
mail	우편물
explorer	탐험가
salary	월급
nuclear	원자핵의
potato	감자
lunar	달의
cage	새장
romantic	낭만적인
relieve	해방시키다
chiefly	무엇보다
nervous	불안한, 침착성이 없는
exert	(힘, 능력을) 내다, 쓰다
specialist	전문가
preparation	준비
continually	계속해서
December	12월
deliver	~를 배달하다
strict	엄격한
terribly	지독하게, 무시무시하게
channel	해협
horror	공포
confess	고백하다
depth	깊이
mineral	광물
opposition	반대
chamber	방
organ	기관
highway	고속도로
worm	벌레
instinct	본능
mountainous	산이 많은
etc.	기타 등등
club	클럽
ghost	유령
proverb	격언
mainly	주로
gigantic	거대한
plenty	많음
exhibition	박람회
echo	메아리
suspicious	의심스러운
rebel	반역자, 반항자
systematic	체계적인
knee	무릎
wind	바람
golden	금빛의
hunter	사냥꾼
globe	구, 지구
repetition	반복
sad	슬픈
wire	철사, 전선
emphasize	강조하다
sincere	성실한, 진실한
supreme	최고의
helpless	어찌할 수 없는
meadow	목초지
inventor	발명가
obey	~에 복종하다
accuracy	정확성
inch	인치
tune	선율
hobby	취미
gentle	온화한
formula	공식
external	외부의
approval	승인
passive	수동적인
faith	믿음
abolish	폐지하다
earthquake	지진
canal	운하
transmit	전달하다
awaken	(잠에서) 깨우다
model	모델
ugly	못생긴
customer	고객
owl	올빼미
rob	빼앗다, 훔치다
competitive	경쟁의
lawn	잔디
relax	긴장을 풀다
topic	화제
suspicion	의심, 혐의
cow	암소
theme	주제, 테마
marvelous	놀라운, 훌륭한
executive	실행하는
July	7월
atom	원자
baseball	야구
cheat	속이다
diary	일기
monster	괴물
soap	비누
advertisement	광고
adjustment	조정, 조절
craft	기술, 공예
restore	회복시키다
retain	~을 보유하다
agreement	동의
hide	(사람, 물건을) 감추다
pearl	진주
purely	순수하게
shine	빛나다
silver	은
impact	충돌, 충격
flourish	번영하다
despise	~을 경멸하다
mature	성숙한
entitle	~라고 칭하다
physician	내과의사
remote	멀리 떨어진
favorite	마음에 드는
lean	기대다
uniform	제복
inevitably	반드시, 필연적으로
conviction	확신, 유죄판결
robber	강도
furnish	(가구 등을) 갖추다
bearing	태도
imaginative	상상력이 풍부한
hunger	굶주림
predict	예언하다, 예시하다
attractive	매력있는
unaware	(~을) 의식하지 못하는
error	잘못
economist	경제학자
loyalty	충성
declare	선언하다
leaf	잎
chain	사슬
tender	부드러운
commercial	상업의
substance	물질
emphasis	강조
tail	꼬리
bone	뼈
merchant	상인
Frenchman	프랑스인
hang	~를 (...에) 걸다
brown-eyed	갈색눈의
rational	이성적인
sufficiently	충분히
eager	열망하는
stock	재고(품)
offend	(남의) 감정을 상하게 하다
insult	(남을) 모욕하다
utterly	아주
piano	피아노
thermometer	온도계
vote	투표하다
chemical	화학의
practically	실제로
succession	연속
well-known	유명한
prevail	널리 퍼져있다
primary	주요한
economics	경제학
player	선수
captain	우두머리
safely	안전하게
march	행진하다
handsome	잘생긴
athlete	운동선수
objection	반대
co-operation	협력
distress	고통
gesture	몸짓, 제스처
oven	오븐
president	대통령
departure	출발
trick	계략
glory	영광
cleanse	깨끗하게 하다
bat	(야구 등의) 배트
housewife	주부
link	연결하다, 잇다
elementary	초보의
recognition	인식
shake	~를 흔들다
imitation	모방, 모조품
doom	운명
satellite	(인공) 위성
Switzerland	스위스
seed	씨
trousers	바지
sympathetic	동정적인
spare	예비의
rub	문지르다, 비비다
influential	큰 영향을 주는
explosion	폭발
logical	논리적인
persist	고집하다
frontier	국경 (지방)
promote	장려하다, 승진시키다
smell	냄새를 맡다
punishment	처벌
restraint	억제, 제지
roof	지붕
puppy	강아지
profound	깊은, 심오한
courageous	용감한
rabbit	토끼
horrible	무서운, 끔찍한
miserable	비참한
cure	치료하다
inferior	열등한
hardship	고난
consume	~을 소비하다
comparatively	비교적
instinctive	본능적인
confirm	확인하다
shopping	물건 사기, 쇼핑
naked	벌거벗은
goodness	선, 친절
data	자료
Mediterranean	지중해, 지중해의
awake	깨우다
sink	가라앉다
misunderstanding	오해
psychologist	심리학자
nourish	~에 영양분을 주다, 키우다
intimate	친밀한
deserve	(~할만한) 가치가 있다
eastern	동쪽의
odd	이상한, 묘한
peculiarity	기묘함, 이상함
instructor	교사
generalization	일반화
amaze	~를 놀라게하다
soup	수프
ceiling	천장
court	재판소
wing	날개
Monday	월요일
politician	정치가
observer	관찰자
complexity	복잡성
mercy	자비
officer	장교, 관리
cruelty	잔인함
favorable	찬성하는, 호의적인
entrance	입구
text	본문
startle	~를 깜짝 놀라게 하다
agricultural	농업의
fashionable	유행하는, 최신식의
department	과, 학부
interview	면접
owing	빚지고 있는
score	득점
expense	비용
editor	편집자
contribution	공헌, 기여
preference	선호
solitary	고독한, 혼자뿐인
musician	음악가
spring	봄
summer	여름
fall	가을
winter	겨울
Sunday	일요일
Monday	월요일
Tuesday	화요일
Wednesday	수요일
Thursday	목요일
Friday	금요일
Saturday	토요일
today	오늘
tomorrow	내일
yesterday	어제
January	1월
February	2월
March	3월
April	4월
May	5월
June	6월
July	7월
August	8월
September	9월
October	10월
November	11월
December	12월
east	동쪽
west	서쪽
south	남쪽
north	북쪽
cosmos	우주
star	별
sun	태양
earth	지구
moon	달
volcano	화산
sea	바다
land	땅
island	섬
sky	하늘
river	강
nature	자연
gull	갈매기
cloud	구름
wave	파도
hill	언덕
mountain	산
forest	숲
lake	호수
air	공기
animal	동물
fox	여우
elephant	코끼리
bat	박쥐
deer	사슴
lion	사자
cow	암소
goat	염소
dog	개
cat	고양이
monkey	원숭이
bear	곰
whale	고래
zebra	얼룩말
hippo	하마
horse	말
camel	낙타
hare	산토끼
rabbit	토끼
wolf	늑대
tiger	호랑이
insect	곤충
moth	나방
butterfly	나비
grasshopper	메뚜기
fly	파리
mosquito	모기
bee	벌
ant	개미
bird	새
swallow	제비
crow	까마귀
swan	백조
seagull	갈매기
crane	학
eagle	독수리
hawk	매
owl	올빼미
cock	수탉
hen	암탉
turkey	칠면조
penguin	펭귄
flower	꽃
lily	백합
pansy	팬지
rose	장미
tulip	튤립
sunflower	해바라기
tree	나무
pine	소나무
maple	단풍나무
leaf	잎
root	뿌리
branch	가지
fish	물고기
shark	상어
goldfish	금붕어
shrimp	새우
crab	게
people	사람들
children	어린이들
baby	갓난아기
adult	어른
woman	여자
man	남자
lady	숙녀
gentleman	신사
friend	친구
student	학생
neighbor	이웃
family	가족
grandmother	할머니
grandfather	할아버지
mother	어머니
father	아버지
son	아들
daughter	딸
brother	형제
sister	자매
aunt	아주머니
uncle	아저씨
cousin	사촌
niece	조카(딸)
nephew	조카(아들)
husband	남편
body	몸
head	머리
face	얼굴
neck	목
back	등
shoulder	어깨
chest	가슴
waist	허리
hip	엉덩이
elbow	팔꿈치
arm	팔
wrist	손목
hand	손
finger	손가락
nail	손톱
stomach	위, 배
leg	다리
knee	무릎
calf	장딴지
ankle	발목
foot	발
toe	발가락
heel	뒤꿈치
skin	피부
bone	뼈
hair	머리카락/털
forehead	이마
brow	눈썹
eye	눈
ear	귀
mouth	입
lip	입술
tooth	이
tongue	혀
nose	코
chin	턱
cheek	뺨
cloth	옷
jacket	웃옷, 자켓
sweater	스웨터
raincoat	비옷
overcoat	외투
trousers	바지
skirt	치마
shorts	반바지
hat	모자
jumper	점퍼
umbrella	우산
sunglasses	썬글라스
nightgown	잠옷
belt	벨트
necklace	목걸이
earring	귀고리
hairpin	머리핀
ring	반지
shoes	신발
sneakers	운동화
handbag	손가방, 핸드백
feeling	감정
hot	매운, 뜨거운
thirsty	목마른
sleepy	졸린
cold	추운
hungry	배고픈
full	배부른
worried	걱정스러운
sick	아픈
lonely	외로운
sad	슬픈
proud	자랑스러운
excited	흥분한
bored	지루한
angry	화난
upset	혼란에 빠진, 성난
surprised	놀란
happy	행복한
tired	피곤한
hospital	병원
doctor	의사
nurse	간호사
dentist	치과
cavity	충치
city	도시
streetlight	가로등
sidewalk	보도
hotel	호텔
taxi	택시
bank	은행
street	거리
church	교회
post office	우체국
police station	경찰서
park	공원
theater	극장
bakery	빵집
city hall	시청
bench	벤치
slide	미끄럼틀
playground	놀이터
tag	술래잡기
hide-and-seek	숨바꼭질
swing	그네
jumping rope	줄넘기
telephone	전화
cellular phone	휴대폰
vehicle	탈것
airplane	비행기
helicopter	헬리콥터
bicycle	자전거
motorcycle	오토바이
bus	버스
yacht	요트
subway	지하철
train	기차
house	집
stairs	계단
garage	차고
floor	마루
roof	지붕
mailbox	우편함
door	문
bed	침대
rug	깔개
kitchen	부엌
toilet	화장실
bathroom	욕실
chimney	굴뚝
soap	비누
toothpaste	치약
toothbrush	칫솔
toilet paper	휴지
thread	실
needle	바늘
room	방
desk	책상
chair	의자
book	책
globe	지구
calendar	달력
wastebasket	휴지통
photograph	사진
picture	그림
lamp	등불
racket	라켓
bag	가방
cooker	요리기구
oven	오븐
refrigerator	냉장고
kettle	주전자
plate	접시
pot	냄비
tray	쟁반
bowl	사발
glass	유리컵
fork	포크
spoon	수저
knife	칼
chopstick	젓가락
living room	거실
television	텔레비전
clock	벽시계
table	테이블
mirror	거울
bookshelf	책꽂이
curtain	커튼
vase	꽃병
ceiling	천장
food	식품
corn	옥수수
cocoa	코코아
coffee	커피
sugar	설탕
butter	버터
salt	소금
bread	빵
roll	롤빵
pie	파이
cake	케이크
milk	우유
sausage	소시지
meat	고기
ham	햄
hamburger	햄버거
rice	쌀
noodles	국수
spaghetti	스파게티
pizza	피자
salad	샐러드
soup	수프
onion	양파
cheese	치즈
tuna	참치
cookies	쿠키
eggs	계란
margarine	마가린
flour	밀가루
doughnut	도우넛
ketchup	케첩
fruit	과일
apple	사과
lemon	레몬
pineapple	파인애플
banana	바나나
melon	멜론
strawberry	딸기
watermelon	수박
chestnut	밤
orange	오렌지
vegetable	야채
cabbage	양배추
potato	감자
carrot	당근
cucumber	오이
tomato	토마토
pumpkin	호박
pepper	고추, 후추
mushroom	버섯
garlic	마늘
school	학교
library	도서관
locker	사물함
school bus	스쿨 버스
gymnasium	체육관
blackboard	칠판
chalk	분필
eraser	지우개
teacher	선생님
pen	펜
ruler	자
pencil	연필
pencil case	필통
notebook	공책
textbook	교과서
map	지도
timetable	시간표
watch	손목 시계
subject	과목
art	예술, 미술
music	음악
English	영어
history	역사
mathematics	수학
science	과학
cello	첼로
guitar	기타
violin	바이올린
piano	피아노
triangle	트라이앵글
job	직업
actor	남자 배우
artist	예술가
announcer	아나운서
barber	이발사
carpenter	목수
pilot	조종사, 파일럿
musician	음악가
singer	가수
cook	요리사
mailman	우편 집배원
farmer	농부
firefighter	소방수
hairdresser	미용사
model	모델
lawyer	변호사
housekeeper	주부
police officer	경찰관
secretary	비서
sports	운동
swimming	수영
baseball	야구
soccer	축구
fencing	펜싱
volleyball	배구
golf	골프
bowling	볼링
skiing	스키
wrestling	레슬링
weather	날씨
sunny	맑은
cloudy	흐린
raining	비가 오는
snowing	눈이 오는
windy	바람부는
foggy	안개 낀
lightning	번개
thunderstorm	천둥
rainbow	무지개
warm	따뜻한
cool	시원한
color	색깔
blue	파랑색
brown	갈색
purple	보라색
yellow	노랑색
green	녹색
white	흰색
gray	회색
pink	분홍색
black	검정색
red	빨강색
calender	달력
year	년, 해
month	달
day	날(하루)
week	주일
weekend	주말
date	날짜
computer	컴퓨터
mouse	마우스
monitor	모니터
keyboard	키보드
printer	프린터
abuse	남용하다
accumulate	축적하다
adopt	채용하다
advertise	광고하다.
affect	영향을 미치다
applaud	박수갈채를 보내다
assent	동의하다
avenge	원수를 무찌르다
banish	추방하다
bore	굴복시키다
bury	매장하다
circulate	순환하다
collect	모으다
compensate	보상하다
comprehend	이해하다
condemn	비난하다
correct	정정하다
deny	부정하다
distribute	분배하다
endeavor	노력하다
envelop	싸다. 덮다
excel	능가하다
exhaust	다 써버리다.
fulfill	(의무 등을) 다하다
heal	치료하다
imitate	흉내내다
infer	추론하다
institute	설립하다
intensify	강하게 하다
intervene	개입하다
maintain	유지(주장)하다
oppose	반대하다
paralyze	마비시키다.
pray	기도하다
proceed	나아가다
profess	공언하다
prophesy	예언하다
purchase	구입하다
recollect	생각해내다
reconcile	화해시키다.
vouch	보증하다
sneer	조소하다
stare	응시하다
stir	휘젓다, 분기시키다
suffice	충분하다
survey	개관(조사)하다,
swear	맹세하다
transfer	이동시키다
upset	뒤집다
vanish	사라지다.
alternative	양자택일의
apparent	명확한
approximate	대강의
artificial	인공의
bare	알몸의
coarse	천박한
conscientious	양심적인
conservative	보수적인
cowardly	겁 많은
dear	친애한, 값비싼
deliberate	신중한
dismal	음침한
dumb	말 못하는
financial	재정의, 금융의
foul	불결한
imaginary	상상의
impudent	뻔뻔스런
incessant	끊임없는
indolent	태만한
infamous	악명 높은
inherent	천부의, 타고난
innocent	무죄의, 청순한
intended	의도적인
laborious	힘드는, 근면한
legitimate	합법의
literary	문학의
loose	느슨한
magnificent	장관의, 멋진
melancholy	우울한
monotonous	단조로운
novel	신기한, 새로운
opposite	반대의
passionate	열정적인
picturesque	그림 같은
plain	명백한, 평원
profitable	유리한
resolute	단호한
respectful	경의를 표하는
royal	왕의, 당당한
sensible	분별 있는
severe	엄격한
significant	중요한
skeptical	의심 많은
sole	유일한
staple	주요한
stubborn	완고한
sufficient	충분한
tedious	지루한
vague	모호한
voluntary	자발적인
account	설명, 계산
affection	애정
agriculture	농업
altar	제단
analysis	분석
ancestor	선조
antiquity	오래됨, 고대
applause	박수갈채
arithmetic	산수
aspect	양상
atmosphere	분위기
attitude	태도
author	작가
authority	권위
awe	두려움
basis	기초
berry	딸기
bough	큰 가지
breadth	폭, 넓이
bribery	뇌물
caprice	변덕
category	부문, 종류
ceremony	의식(행사)
character	성격, 문자, 인물
commerce	상업
community	공동사회
compliment	칭찬, 아첨
conflict	다툼
consciousness	의식
contact	접촉
correction	정정, 교정
courtesy	예의
cowardice	겁
crisis	위기
decade 10	년간
discipline	훈련, 예절
disease	병
draft	초고
eloquence	웅변
enthusiasm	열심, 열광
environment	환경
epoch	시대, 신시대
exhibition	전람회, 전시
experiment	실험
exploit	공적, 공훈
export	수출
facility	손쉬움, (복)설비
famine	기아, 굶주림
farewell	이별
feature	특징 (복)용모
flour	밀가루
hare	산토끼
heaven	천국
heretic	이단자
honesty	정직
hypothesis	가설, 가정
increase	증가
influence	영향
instinct	본능
insult	모욕
intention	의지, 의도
interference	방해, 간섭
invalid	환자, 허약한
laboratory	실험실, 연구실
manifest	명백한
manuscript	원고, 사본
menace	위협
miser	구두쇠
mold	틀, 성질
mourning	애도, 상복
negligence	태만
opponent	대립자, 적
optimist	낙천가
parliament	의회, 국회
pattern	모범, 모양
peer	귀족, 물끄러미 보다
persuasion	설득
philosopher	철학자
pier	부두
pioneer	개척자, 선구자
planet	혹성
praise	칭찬
preface	서문
procedure	진행, 처리
project	계획
prospect	전망, 조망
pursuit	추적, 추구
quotation	인용
rein	고삐
scent	냄새, 단서
sigh	한숨
snare	덫
sojourn	체재
solitude	고독
spectator	구경꾼
steel	강철
strife	투쟁
stuff	재료, 채우다
surface	표면
synthesis	종합
abstract	추출하다, 추상적인
accommodate	수용하다
adapt	적응시키다.
advance	전진하다
advocate	포옹하다
anticipate	기대하다
ascertain	확인하다
astound	놀라게 하다
award	수여하다, 상
bewilder	당혹시키다.
celebrate	축하하다
cite	인용하다.
comment	비평하다
compound	합성하다
compromise	타협하다
confine	제한하다
convert	바꾸다
damn	저주하다
destroy	파괴하다
emigrate	이주하다
entertain	대접하다
exaggerate	과장하다
execute	실행하다
exhibit	전시하다.
found	설립하다
hasten	서두르다
illustrate	예증하다
indicate	가리키다
injure	상처 입히다.
intend -	할 생각이다.
interrupt	방해하다.
irritate	초조하게 하다
operate	조작(수술)하다.
ordain	명하다
persecute	박해하다
precede -	의 앞에 일어나다
produce	생산하다.
prolong	연장하다
protest	항의하다
recommend	추천하다
resent	화를 내다
seize	잡다
separate	분리하다
spoil	망치다
stifle	질식시키다.
strive	노력하다
summon	불러내다.
suspect	의심하다.
torment	괴롭히다.
transport	수송하다
accurate	정확한
ancient	고대의
appropriate	적절한
arrogant	거만한
awkward	어색한
bold	대담한
characteristic	독특한
conscious	의식하는
contemporary	현대의
daring	대담한
decent	훌륭한
disinterested	공평한
divine	신성한
enthusiastic	열광적인
fluid	유동성의
huge	거대한
humane	인정미가 있는
imaginative	상상력이 풍부한
inadequate	불충분한
individual	개인의
inevitable	피할 수 없는
ingenious	영리한
initial	최초의
insane	광기의
intimate	친밀한
legal	합법적인
literate	읽고 쓸 줄 아는
loyal	충실한
medieval	중세의
modern	현대의
naughty	버릇없는
obvious	명백한
physical	육체의
pious	경건한
proficient	숙달한, 능숙한
public	공공의
respective	각자의
sacred	신성한
sensitive	민감한
shrewd	통찰력이 있는
sincere	성실한
spiritual	정신적인
subtle	미묘한
striking	눈에 띈, 현저한
suitable	적절한
sympathetic	인정 있는
thorough	철저한
vain	무익한, 허황된
vicious	심술궂은, 악덕의
wretched	참혹한, 비참한
access	접근
adaptation	적응
agency	대리점
alliance	동맹
ambassador	대사
anarchy	무정부상태
antipathy	반감
appetite	식욕
architecture	건축
ascent	오름
astronomy	천문학
barrier	장애, 장벽
benefit	이익, 은혜
bomb	폭탄
bravery	용기
bribe	뇌물
budget	예산
catastrophe	대 재해
cell	세포, 독방
chaos	무질서, 혼란
circumstance	환경, 사정
communism	공산주의
complement	보어
concept	개념
conscience	양심
consequence	결과
contrast	대조
countenance	표정
coward	겁쟁이
creature	생물, 창조된 것
debt	부채
decrease	감소
extract	추출물
faculty	능력
fare	운임
fatigue	피로
flesh	고기, 육체
haven	항구, 정박소
heir	상속인
hypocrisy	위선
import	수입
inference	추론
insight	통찰력
instrument	도구, 악기
intension	긴장
intercourse	교제
interval	간격
irony	비꼼
label	딱지
lavatory	세면장, 화장실
literature	문학
mankind	인류
maxim	격언
mechanism	기구, 구성
memorandum	메모, 비망록
mischief	장난, 위해
misery	참혹함
monopoly	독점
muscle	근육
nuisance	피해, 귀찮은 것
opportunity	기회
patriotism	애국심
perfume	향수, 향기
phenomenon	현상
physics	물리학
piety	경건, 효도
post	기둥, 우편, 지위
predecessor	전임자, 선배
principle	주의, 원리
progress	진보
propriety	예의, 적당
psychology	심리학
quay	선착장
rebate	할인, 환불
resignation	사직
sacrifice	희생
scope	범위, 시야
significance	의의, 중요성
site	부지, 위치
society	사회
soul	영혼, 사람
sovereign	주권자, 군주
solace	위로
spectacle	관경, (복)안경
spirit	정신
stimulus	자극
subtlety	미묘함
suit	옷, 소송
supplement	부록, 보충
sword	검
tail	꼬리
talent	재능
theory	이론
throne	왕좌
tribe	부족, 종족
tyrant	전제군주, 폭군
vein	혈관, 기질
wage	임금, 급료
virtue	미덕, 장점
witness	증인, 목격자
acknowledge	인정하다
admit	인정하다
appreciate	인식(감사)하다
attempt	시도하다
betray	배반하다
boast	자만하다
calculate	계산하다
cast	던지다. 배역
claim	요구(주장)하다
coincide	일치하다
combine	연결시키다
complete	완성하다
compute	계산하다
concern	관계하다
congratulate	축하하다
construct	건설하다
create	창조하다
declare	선언하다
demand	요구하다
develop	발달하다
display	전시하다
divide	나누다
entrust	맡기다
exceed	넘다, 이기다
expend	소비하다
generate	발생시키다
grasp	잡다, 이해하다
hesitate	주저하다
impress	인상(감명)을 주다
inherit	상속하다
inspect	검사하다
judge	판단하다
launch	발사(시작)하다
meditate	숙고(명상)하다
oblige	의무를 지우다
obtain	얻다
outnumber -	보다 수가 많다
overburden	지나치게 부담주다
overestimate	과대평가 하다
overwhelm	압도하다
perform	실행하다
permit	허락하다
predict	예언하다
prescribe	처방하다
pretend	가장하다
prohibit	금지하다
propose	제안(신청)하다
protect	보호하다
publish	출판하다
pursue	추적하다
react	반응하다
recover	회복하다
reinforce	보강하다
relax	긴장을 풀다
relieve	제거하다
remove	제거하다
require	요구하다
resign	사직하다
revive	부활하다
select	고르다
simplify	간단히 하다
steer	조종하다
subscribe	서명하다
support	지지하다
suspend	매달다, 연기하다
undertake	떠맡다
urge	재촉하다
abrupt	퉁명스러운
chemical	화학의
conspicuous	현저한
distinct	분명한
earnest	진지한
engaging	매력적인
eternal	영원한
fair	공정한, 정기시장
final	최후의
fluent	유창한
furious	사나운
genuine	진짜의
immediate	즉시의
inborn	타고난, 선천적인
innate	타고난, 선천적인
irregular	불규칙한
major	주요한
material	물질적인, 재료
medial	중간의
miniature	소형의, 모형
mournful	슬픔에 잠긴
obscure	모호한, 애매한
occasional	때때로
persistent	끈질긴
precious	귀중한
preferable	바람직한
preliminary	예비의
priceless	매우 중요한
primitive	원시의
promising	장래 유망한
rapid	급속한
reasonable	타당한
restless	침착하지 못한
ridiculous	어리석은
secure	안전한
shameful	부끄러워하는
steadfast	확고한
steep	가파른
sublime	숭고한
timid	소심한
trivial	사소한
trustworthy	신뢰할 수 있는
unanimous	만장일치의
visible	눈에 보이는
accident	사고, 우연
ambition	야망
bait	유혹, 먹이
bond	굴레, 속박
brute	짐승, 잔인한 사람
cancer	암
civilization	문명
colony	식민지
companion	동료
compassion	동정
conduct	행위, 지휘하다
criminal	범인, 범죄의
damage	손해(를 주다)
death	죽음
dialect	방언, 사투리
doctrine	주의, 학설
economy	경제, 절약
emotion	정서, 감정
envy	부러움(워하다)
estate	재산, 지위
explanation	설명
explosion	폭발
factory	공장
folly	어리석음
function	기능
generosity	관용, 관대
grade	단계, 학년, 성적
gravitation	중력, 인력
grief	슬픔
hell	지옥
horizon	지(수)평선
illumination	조명
income	수입, 소득
invitation	초대
legend	전설
lung	허파
maintenance	유지, 주장
manifestation	명시
mariner	수부, 선원
merchandise	상품
merit	장점
method	방법
mission	사명, 사절단
monotony	단조
obligation	의무
observance	준수, 의식, 습관
occasion	경우, 기회
offspring	자손
optimism	낙천주의
organization	조직
owner	소유주
pastime	기분전환, 오락
policy	정책, 방법
popularity	인기
postscript	추신
poverty	가난
preparation	준비
privilege	특권
product	생산물, 작품
profession	직업, 공언
propaganda	선전
prophecy	예언
punishment	벌
regulation	규칙
relation	관계
relief	안심, 구원
reparation	배상
research	연구, 조사
restoration	회복, 부흥
ruin	파멸(시키다)
seed	씨
shortage	부족
solution	해결
status	지위, 상태
suggestion	제안
survival	생존
symptom	징후, 징조
tax	세금
telegram	전보
tendency	경향, 추세
threat	협박
tradition	전통
treaty	조약
usage	사용(법)
value	가치, 평가하다
vision	시력, 통찰력
vigor	정력, 활력
vogue	유행
weapon	무기
accomplish	완성하다
acquire	획득하다
appoint	임명하다
attain	달성하다
bless	축복하다
broadcast	방송하다
carry	운반하다
cherish	소중히 하다
classify	분류하다
combat	싸우다
compel	강제하다
complicate	복잡하게 하다
conceive	(생각 등을) 품다
conclude	결론을 내리다
consider	숙고하다
convey	전하다
debate	논쟁하다
defend	막다, 변호하다
demonstrate	표시하다
discharge	발사하다
disturb	방해하다
encourage	용기를 북돋우다
estimate	평가하다
exclude	제외하다
explore	탐험하다
forbear	참다
graduate	졸업하다
grow	성장하다
identify	동일시하다
improve	진보하다
innovate	혁신하다
invent	발명하다
lament	한탄하다
mar	흠나게 하다
misunderstand	오해하다
observe	관찰하다
outdo -	을 이기다
overact	지나치게 행동하다
overcome	정복하다
pant	헐떡이다
perish	죽다, 멸망하다
pierce	꿰뚫다
prepare	준비하다
preside	사회를 보다
prevent	방해하다
promote	승진시키다
prosper	번영하다
prove	증명하다
qualify	자격을 주다
recite	암송하다
regulate	규정하다
relate	관련시키다
release	해방하다
remain	남다
repair	수리하다
reproach	비난하다
reserve	보존(예약)하다
restore	회복시키다
scorn	경멸하다
soothe	달래다
struggle	투쟁하다
supply	공급하다
surpass	보다 우수하다
treat	다루다, 대접하다
unify	통일하다
warn	경고하다
absurd	어리석은
adequate	충분한, 적당한
ambiguous	애매한
concrete	구체적인
critical	비평의
disobedient	순종하지 않는
domestic	가정의, 국내의
eccentric	별난
enormous	거대한, 막대한
exact	정확한
feudal	봉건제의
flexible	유연한
fortunate	행운의
fundamental	기초의
gentle	친절한
gigantic	거대한
illegal	비합법적인
immoral	부도덕한
inclusive	모든 것을 포함하는
involuntary	무의식의
irresponsible	무책임한
marine	바다의
mature	성숙한
military	군대의
monthly	매월의
neutral	중립의
obstinate	완고한, 고집 센
precise	정확한, 정밀한
prehistoric	유사이전의
premature	조숙한
prime	제일의, 주요한
profound	심오한
proper	적당한
radical	근본(급진)적인
rational	합리(이성)적인
reserved	보류된, 예약된
revolutionary	혁명적인
savage	야만적인
selfish	이기적인
shy	수줍은
steady	확실한, 착실한
stern	엄격한
supreme	최고의
tranquil	조용한
tropical	열대의
ultimate	최후의
universal	일반적인
vulgar	저속한, 천한
aid	원조, 돕다
alarm	놀람, 경보
analogy	유사
argument	논의
barbarian	야만인
biology	생물학
canal	운하
charity	자선사업, 박애
column	(신문 등의)난
conceit	자만
crime	죄, 범죄
critic	평론가
dawn	새벽
decoration	장식
difficulty	곤란
ebb	간조
education	교육
emphasis	강조
epidemic	전염병
ethics	윤리학
expedition	탐험대
exploration	탐험
fame	명성
frustration	좌절, 욕구 불만
fund	자금, 기금
generation	세대
generous	관대한
gratitude	감사
gravity	중력, 중대함
grieve	슬퍼하다
hatred	증오
horror	공포
impulse	충동
indignation	분개
jealousy	질투
labor	노동(하다)
logic	논리(학)
luxury	사치(스러운 물건)
majority	다수파
manufacture	제조(하다)
marriage	결혼
merchant	상인
misfortune	불운
missionary	선교사
monster	괴물
murderer	살인자
nightmare	악몽
oblivion	망각
obstacle	장해(물)
occupation	직업, 점령
omen	전조
orbit	궤도
orient	동양
outbreak	발발
passage	통로, 경과
perseverance	인내
pollution	오염
portrait	초상화
posterity	자손
posture	자세
prejudice	편견
press	출판물, 신문, 잡지
probability	전망, 확률
prohibition	금지
property	재산, 특성
proposal	제안, 신청
relative	친척
removal	이동, 제거
reputation	평판, 명성
revolution	혁명
rumor	소문
shame	부끄러움
slang	속어
starvation	아사, 기아
submarine	잠수함
surplus	여분
symposium	토론회
temptation	유혹
tension	긴장
torture	고문, 괴롭히다
traffic	교통
triumph	승리, 대성공
utterance	발언, 발성
vanity	허영심, 공허함
vocation	직업
vow	맹세(하다)
adjust	조정하다
adorn	장식하다
allege	주장하다
allude	암시하다
animate	활기를 주다
apprehend	이해하다
assault	공격하다
assign	할당하다
assume	추정하다
befall	(나쁜 일이) 생기다
capture	잡다, 포획
commit	(죄, 과실을) 범하다
concede	양보하다
confirm	확실하게 하다
confront	직면하다
conserve	보존하다
conspire	공모하다
contradict	모순되다
cultivate	경작하다
define	정의하다
delay	지연시키다
deposit	맡기다, 저금
deserve	가치가 있다
detect	발견하다
determine	결정하다
dignify	위엄을 갖추다
discard	버리다
disdain	경멸하다
dismiss	해고(해산)하다
distract	(마음을) 돌리다
dominate	지배하다
embark	출항하다
embrace	포옹하다
establish	설립하다
exalt	찬양하다
expose	드러내다
fix	고정(수리)하다
gather	모으다
hinder	방해하다
imply	암시하다
infect	감염시키다
inspire	(영감을)불어넣다
intoxicate	취하게 하다
invest	투자하다
kindle	불태우다
lure	유혹하다
measure	측정하다
multiply	증가시키다
negotiate	교섭하다
perceive	깨닫다, 이해하다
ponder	숙고하다
predicate	단정(서술)하다
prevail	보급하다, 이기다
rebuke	비난(하다)
reform	개혁(하다)
rejoice	기뻐하다
repose	휴식(하다)
rescue	구출(하다)
restrict	제한하다
retire	퇴직하다
retrogress	후퇴하다
scrutinize	자세히 조사하다
signify	의미하다
speculate	사색하다
sting	찌르다
subside	누그러지다
suppress	억압하다
sustain	유지(지지)하다
thrive	번영하다
transcend	초월하다
transform	변화시키다
undergo	경험하다
venture	모험(하다)
warrant	보증하다
acute	날카로운
annual	매년의
attractive	매력적인
ceremonial	의식의
congenial	성미가 맞는
contradictory	모순된
cordial	충성스러운
credulous	속기 쉬운
deplorable	한탄스러운
discreet	심려 깊은
efficient	능률적인
extravagant	사치스런
forlorn	고독한
gallant	용감한
humble	겸허한
impartial	공평한
impertinent	부적당한, 건방진
indebted	신세진
instructive	유익한
lofty	매우 높은
maximal	최대한의
multiple	다수의
negligible	하찮은
parallel	평행의
pensive	우울한
pertinent	적절한
possessed	신들린, 정신팔린
predominant	우세한, 유력한
primary	초보의, 주요한
prompt	신속한
punctual	시간을 지키는
relevant	관련된, 적절한
reverse	반대의
ripe	익은
sagacious	현명한
sheer	완전한
sinister	불길한, 사악한
sly	교활한
solitary	고독한, 쓸쓸한
straight	똑바른
substantial	본질적인
textile	직물(의)
transparent	투명한
upright	정직한
valid	유효한
venerable	존경해야 할
abstinence	절제
agony	고뇌
anguish	심한 고통, 고뇌
armament	군비
autobiography	자서전
benefactor	은인, 후원자
boredom	싫증
calamity	재난
caricature	풍자 만화
circulation	순환
colleague	동료
commodity	상품, 일용품
component	구성요소
concord	일치
confinement	감금
congregation	집회, 집합
consolation	위로
constitution	구성, 조직
contentment	만족
convention	인습, 회의
cradle	요람
creed	신조, 주의
decree	법령, 판결
delight	기쁨
destination	목적지
digest	요약, 소화하다
disaster	재난, 재해
discord	불화
disposition	기질, 배치
efficiency	능률
eminence	높은 곳, 탁월
evidence	증거
exertion	노력
fallacy	오류
fever	열(병)
formula	공식
fright	공포, 경악
genius	천재
glacier	빙하
heredity	유전(생물학적)
ideal	이상
implement	도구,시행하다
infancy	유년기
inhabitant	주민
intervention	개입
intuition	직관
issue	발행, 유출
legislation	입법, 법률
marvel	경이, 경탄하다
mob	폭도, 군중
modification	수정, 변경
multitude	다수, 군중
navigation	항해술, 항공술
net	그물, 순이익
nutrition	영양물
oracle	신탁
output	생산(고)
patience	인내(력)
perplexity	당혹
perspective	원근화법, 전망
plague	역병, 전염병
pomp	장관, 화려, 허세
proffer	제공(하다)
pulse	맥박(치다)
realm	왕국, 영토
reliance	신뢰
relish	풍미 취향
renown	명성
resemblance	유사(점)
retrospect	회상
revolt	반란
rigidity	엄격, 딱딱함
routine	정해진 일, 일상의
scheme	계획
sermon	설교
skyscraper	초고층 빌딩
snob	속물
speculation	사색
standpoint	입장
strain	긴장, 잡아당기다
administer	관리하다
affirm	단언하다
allot	할당하다
allure	유혹하다
annihilate	전멸시키다
approve	찬성(인정)하다
ascend	오르다
assemble	모이다
assimilate	동화하다
astonish	놀라게 하다
beguile	속이다
carve	조각하다. 새기다
compete	경쟁하다
confer	상담하다
conform	(규칙을)따르다
confuse	혼란시키다
console	위로하다
constitute	구성(설립)하다
convince	확신시키다
curse	저주(욕설)하다
defy	거부(무시)하다
depict	묘사하다
depress	기를 꺽다
destine	운명 지우다
detest	몹시 싫어하다
diminish	줄이다
discern	식별하다
disguise	변장시키다, 감추다
dispute	논쟁(하다)
diversify	변화시키다
dread	무서워하다, 공포
embarrass	당혹시키다
emerge	나타나다
evade	피하다, 모면하다
exclaim	외치다
extend	확장(연장)하다
flourish	번영하다
grant	인정하다
impair	손상하다
imprison	투옥하다
insert	삽입하다
instruct	가르치다
invade	투입(침입)하다
involve	포함(수반)하다
lurk	숨다, 잠복하다
modify	수정(변경)하다
muse	숙고(명상)하다
obstruct	방해하다
perplex	당혹시키다
preach	설교하다
predominate	지배(우세)하다
protract	오래 끌다
refine	맑게 하다
refresh	활기를 돋우다
renounce	포기(부인)하다
reproduce	재생(번식)하다
resist	저항하다
resume	다시 시작하다
retort	대꾸(하다)
revise	개정하다
slumber	자다, 잠
spur	자극(하다)
stoop	허리를 굽히다
superintend	감독(관리)하다
surmount	(곤란을)이겨내다
swell	부풀다, 팽창
throb	(심장이)고동치다
transcribe	베끼다
translate	번역하다
uphold	지지(지탱)하다
verify	확인하다
withdraw	철회하다
adverse	반대의, 불리한
ardent	열심인
audible	들리는
ceremonious	형식적인
comprehensive	포함하는
congregational	회중의
corrupt	부패한, 타락시키다
cruel	잔혹한
desolate	황폐한
diverse	다양한
evident	명백한
fierce	격심한
formal	형식적인, 정식의
genial	친절한, 온화한
immense	막대한, 거대한
impatient	참을 수 없는
incomparable	비교 할 수 없는
indignant	화난
keen	날카로운, 열심인
marvellous	놀랄 만한
miraculous	기적적인
mutual	상호간의
notable	저명한
pathetic	애절한, 슬픈
perilous	위험한
perverse	사악한, 못된
potent	유력한
prerequisite	미리 필요한
primeval	원시시대의
provident	용의주도한
quaint	이상한
remote	멀리 떨어진
robust	건강한, 강한
sanitary	위생적인
silly	어리석은
slender	가느다란, 희박한
solemn	엄숙한, 진지한
spontaneous	자발적인
sterile	불모의
strenuous	정력적인
sullen	부루퉁한
suspicious	수상한
tidy	정돈된
tremendous	무서운, 엄청난
utmost	최대한의
vast	광대한, 막대한
adolescence	사춘기
algebra	대수
apparatus	장치
aviation	비행, 항공
biography	전기
brevity	간결함
caution	주의, 경고
clue	실마리, 단서
competence	능력
compulsion	강제
concordance	일치
confirmation	확인
congress	회의
consolidation	강화
contagion	전염
context	문맥
conversion	전환
craft	기술
curiosity	호기심
defiance	도전, 무시
denial	부정, 거부
detective	탐정(의)
dialogue	대화
diplomacy	외교
discernment	식별
discordance	불화
dogma	교의, 교리
elusion	도피
enterprise	사업
evolution	진화, 발전
expedience	편의
fate	운명
flavor	풍미
frame	틀, 골조
geometry	기하학
grave	묘, 중대한
humanism	인도주의
inclination	경향, 취향
infant	유아
inspiration	영감
introspection	자기반성
investigation	조사
landscape	풍경
majesty	위엄
minister	장관
mockery	조롱, 놀림
monologue	독백
mutuality	상호관계
navy	해군
oath	맹세
pang	격통
pedestrian	보행자
persecution	박해
perspiration	발한
plausibility	그럴싸함
precaution	예방책, 주의
pretext	구실
profile	옆얼굴
range	범위, 산맥
recess	휴식
relic	유적, 유물
remedy	치료법(약)
representative	대표자
resort	휴양지
reverence	존경(하다)
reward	보답(하다)
riot	폭동(을 일으키다)
satellite	위성
scrutiny	정밀 검사
sculpture	조각
shade	그늘, 미묘한 차이
slave	노예
snobbery	속물 근성
spokesman	대변인
substance	본질
suppression	억압
tact	재치, 눈치
territory	영토
testimony	증언, 증거
trait	특색
transition	변천, 과도기
treason	반역
admonish	훈계하다
agitate	선동하다
amaze	놀라게 하다
annoy	초조하게 하다
argue	주장하다
assail	공격하다
associate	교제(연상)하다
attract	매혹하다
behave	행동하다
complain	불평하다
confess	자백하다
confound	혼란시키다
conquer	정복하다
consolidate	강화하다
contain	포함하다
crawl	기어가다
decay	부패(하다)
degrade	지위를 내리다
deplore	한탄하다
describe	묘사하다
detach	떼어내다
deteriorate	나빠지다
devise	궁리하다
disarm	비무장화하다
discriminate	구별(차별)하다
disgust	혐오(스러워 하다)
distort	왜곡하다
divert	기분전환 하다
elect	선출하다
embody	구체화하다
enchant	매혹하다
evolve	진화하다
foster	기르다
grudge	원한(을 품다)
implore	탄원하다
induce	권유하다
intercept	가로채다
invert	거꾸로 하다
isolate	고립시키다
magnify	확대(과장)하다
mourn	슬퍼하다
neglect	무시(게을리)하다
penetrate	관통하다
plead	변호(탄원)하다
predetermine	예정하다
preserve	보존(보호)하다
provoke	화나게 하다
reflect	반사(숙고)하다
regret	애석하게 여기다
repent	후회하다
reprove	꾸짖다
restrain	억제하다
retain	보유하다
retreat	퇴각(하다)
salute	인사(하다)
seclude	격리하다
sob	흐느껴 울다
stimulate	자극하다
subdue	정복하다
supervise	감독하다
surround	둘러싸다
tend -	하는 경향이 있다
tolerate	참다, 묵인하다
transfigure	형태를 바꾸다
transmit	전하다, 보내다
utter	발언하다
vote	투표(하다)
wither	시들다, 말라죽다
ample	충분한
astray	길을 잃은
awful	지독한, 몹시 싫은
complacent	자기 만족의
compulsory	의무적인
conventional	인습적인
credible	신뢰할 수 있는
curious	호기심이 강한
diplomatic	외교의
dreary	처량한, 음침한
exquisite	절묘한, 정교한
frivolous	경박한, 하찮은
hideous	소름 끼치는
immortal	불멸의
imperial	제국의, 황제의
incredible	믿을 수 없는
insolent	거만한
lavish	통이 큰, 낭비하다
maternal	어머니의
moderate	적당한
outstanding	눈에 띈
peculiar	독특한, 특유의
perpetual	영원한, 끊임없는
petty	사소한, 작은
potential	가능성이 있는
primal	최초의, 원시의
prodigal	방탕한, 사치스런
prudent	신중한
rapt	넋을 잃은, 골몰한
resourceful	수완이 좋은
rigid	딱딱한, 엄격한
ruthless	무자비한
serene	청명한, 침착한
simultaneous	동시의
slight	적은, 경시하다
stable	안정된, 마구간
stiff	견고한, 딱딱한
subconscious	잠재의식의
superficial	표면의, 천박한
terminal	종점(의)
transient	덧없는, 일시적인
vacant	비어있는
vehement	격심한, 열렬한
vile	비열한, 아주 싫은
visual	시각의, 눈에 보이는
affluence	풍부
altitude	고도, 높이
aristocracy	귀족(정치)
aspiration	열망
beast	짐승
bliss	최고의 기쁨
burden	무거운 짐, 부담
capitalism	자본주의
censure	비난(하다)
collapse	붕괴(되다)
commitment	위탁, 공약
competition	경쟁
concession	양보, 특권
confidence	신뢰, 자신
confusion	혼란, 혼동
conservation	보존, 보호
conspiracy	음모, 공모
controversy	논쟁
conviction	확신
credit	신용
deceit	사기
deficiency	부족
depiction	묘사
dictator	독재자
disarmament	군비축소
disciple	제자
disorder	무질서, 혼란
domain	영토, 영역
equator	적도
faith	신뢰
feat	공적
focus	초점
friction	마찰
germ	세균
greed	탐욕
hygiene	위생
ignorance	무지
indignity	모욕, 경멸
insurance	보험(금)
intruder	침입자
investment	투자
layer	층
malice	악의, 원한
miracle	기적
modesty	겸손
nerve	신경
notion	개념, 생각
outlook	전망, 견해
patent	전매특허
periodical	정기간행물, 잡지
personality	개성, 인격
phase	국면, 단계
plea	탄원, 변명
prisoner	죄수, 포로
prominence	눈에 띔, 명성
ray	광선
recession	후퇴
religion	종교
republic	공화국
riddle	수수께끼
rotation	회전, 순환
scale	규모, 척도
sequence	연속, 결과
shelter	피난처
slavery	노예 제도
specimen	견본
stability	안정
statue	조상(彫像)
submission	복종
summary	요약
suspicion	의심
tactics	전술
temperance	절제
terror	공포
throng	무리(짓다)
traitor	배신자, 반역자
transmission	전달, 송신
trend	경향
tumult	소동
unity	통일
vacuum	진공
wealth	부, 재산
truce	휴전
uttermost	최대한도
vow	맹세(하다)
welfare	복지, 번영
twilight	어스름, 황혼
abandon	포기(단념)하다
absorb	흡수하다
alternate	교대하다
anticipate	기대하다
approve	찬성하다
ascend	오르다
attack	공격하다
bear	참다
breed	기르다
collapse	붕괴하다
compel	억지로 시키다
compose	구성하다
consume	소비하다
continue	계속하다
criticize	흠을 잡다
declare	단언하다
descend	내려가다
devise	고안하다
discourage	실망시키다
display	전시하다
domesticate	길들이다
emphasize	강조하다
encourage	용기를 주다
examine	조사하다
explain	설명하다
explode	폭발하다
face	직면하다
finish	마치다
flourish	번영하다
gain	얻다
gratify	만족시키다
import	수입하다
increase	늘리다
infer	추론하다
initiate	시작하다
investigate	조사하다
maintain	유지하다
mingle	섞다
nourish	영양을 주다
obtain	획득하다
occur	발생하다
participate	참가하다
perspire	땀을 흘리다
postpone	연기하다
pretend	가장하다
prove	증명하다
puzzle	당혹시키다
recall	생각해내다
recognize	인정하다
reduce	줄이다
regard	간주하다
release	해방하다
replace	갈아치우다
require	요구하다
respect	존경하다
restrict	제한하다
reveal	드러내다
scatter	흩뿌리다
solve	해결하다
subtract	감하다
supply	공급하다
suppose	추측하다
surpass	우수하다
utilize	이용하다
withhold	보류해두다
yield	지다, 생산하다
absolute	절대적인
absurd	어리석은
affluent	부유한
arctic	북극의
awkward	서투른
capable	유능한
competent	능력 있는
conclusive	결정적인
consistent	일관된
crucial	결정적인
deficient	불충분한
dependent	의존하는
dismal	우울한
drastic	철저한
efficient	능률적인
enormous	거대한
fertile	기름진, 비옥한
frequent	빈번한, 잦은
frugal	검약한
genuine	진짜의
hostile	적의가 있는
ignoble	비열한
internal	내부의
intricate	복잡한
irrational	불합리한
masculine	남성의
mental	마음의
moderate	적당한
modest	겸허한
mortal	필멸의
numerous	다수의
objective	객관적인, 목적
obstinate	완고한
Occidental	서양의
orthodox	정통의
particular	특별한
patient	인내심이 있는
prior	앞의
profound	심오한
reasonable	이성적인
regular	규칙적인
rude	무례한
sane	제정신의
secure	안전한
senior	연상의
sheer	완전한
significant	중요한
sober	술에 취하지 않은
solemn	엄숙한, 진지한
specific	특정의
substantial	상당한
superficial	천박한
superior	뛰어난
temporary	일시적인
thick	두꺼운
tiny	작은
tranquil	평온한
upset	뒤집힌
valid	유효한
advantage	유리
ancestor	선조
bound	한계
degradation	가격인하
demand	수요
destiny	운명
diversity	다양성
ebb	썰물, 간조
evidence	증거
experience	경험(하다)
feature	특징
gratitude	감사
incidence	발생
institution	설립
justice	정의
means	수단, 방법
minority	소수(파)
obstacle	장해
opportunity	기회
peril	위험
pessimist	비관주의자
prejudice	편견
profit	이익
prose	산문
quality	질, 특질
reluctance	마지못해함
sacrifice	희생
sympathy	동정, 공감
synthesis	종합
threat	위협
tolerance	인내
verse	운문, 시
view	의견
whisper	속삭임
wholesale	도매
bias	편견
theme	주제
thermometer	온도계
treachery	배신, 반역
tyranny	전제정치, 폭정
variety	변화, 다양성
vice	악덕
province	영역, 지방
refuge	은신처
retail	소매
subsequent	다음의, 뒤의
superstition	미신
symmetry	대칭, 균형
taint	얼룩, 더럽히다
testament	유언, 성서
tide	조수, 풍조
transaction	처리, 거래
trap	함정(에 빠지다)
trial	재판, 시도
assimilate	동화(흡수)하다
crumble	붕괴하다
tame	길들이다
relative	상대적인
clumsy	서투른, 조잡한
radical	철저한
barren	불모의, 빈약한
wasteful	낭비하는
external	외부의
complicated	복잡한
feminine	여성의
paternal	아버지의
temperate	적당한, 절제하는
humble	겸허한
stubborn	완고한
evident	명백한
heterodox	이교의, 이단의
posterior	뒤의, 후방의
junior	손아래의, 후배의
considerable	상당한
serene	평온한, 온화한
abolish	폐지하다
affect	영향을 끼치다
alter	바꾸다
analyze	분석하다
attach	붙이다. 첨부하다
attribute	탓으로 돌리다
blame	비난하다
cancel	취소하다
commence	시작하다
compensate	보상하다
conceal	감추다
convey	전하다
deceive	속이다
depend on	의지하다
despise	경멸하다
determine	결심(결정)하다
diffuse	발산(유포)하다
dismiss	해고하다
distinguish	구별하다
emancipate	해방하다
encounter	우연히 만나다
establish	설립하다
exhaust	다 써버리다
explode	폭발하다
extinguish	끄다
fascinate	매료하다
foster	기르다, 보살피다
generate	일으키다
imply	암시하다
include	포함하다
indicate	나타내다
inhabit -	에 살다
isolate	분리하다
memorize	암기하다
neglect	무시하다
obey	따르다
occupy	(장소 등을) 차지하다
omit	생략하다
overtake	따라붙다
preform	실행하다
ponder	숙고하다
predict	예언하다
proclaim	선언하다
purchase	구입하다
quit	그만두다
recede	후퇴하다
refuse	거절하다
repel	격퇴(반발)하다
represent	나타내다
resemble -	을 닮다
restrain	억제하다
reveal	나타내다
shift	옮기다
submit	제출하다
support	지지하다
suppress	제압하다
surrender	항복하다
tremble	떨다
violate	(법률을)어기다
withstand	저항하다, 참다
yearn	열망하다
abstract	추상적인
adolescent	청년기의
alien	외국의
antarctic	남극의
artificial	인공의
barren	불모의
boring	지루한
celebrated	유명한
colloquial	구어의
competent	유능한
complicated	복잡한
cruel	무자비한
definite	명확한
disgusting	매우 싫은
domestic	국내(가정)의
dubious	의심스러운
essential	본질적인, 필수의
expensive	값비싼
familiar	친한
filthy	더러운
fortunate	행운의
futile	쓸모 없는
genetic	유전의
guilty	유죄의
haughty	거만한
ignoble	천한
incredible	믿을 수 없는
indispensable	절대 필요한
inferior -	보다 열등한
innate	타고난
intolerable	참을 수 없는
invisible	눈에 보이지 않는
irrelevant	부적절한
legal	합법적인
material	물질적인
mature	성숙한
minor	소수의
modern	현대의
moral	도덕적인
normal	정상의
objective	객관적인
obscure	모호한
obvious	분명한
odd	홀수의
ordinary	보통의
partial	불공평한
perfect	완전한
perpendicular	수직의
pervasive	퍼지는
polite	예의바른
postwar	전후의
primitive	원시적인
probable	있을 법한
progressive	진보적인
public	공적인
rational	합리적인
reckless	무모한
relative	비교적인
rural	시골(전원)의
scanty	빈약한, 결핍된
separable	분리할 수 있는
shrewd	현명한
significant	중요한
sophisticated	교양이 있는
strict	엄격한
subjective	주관적인
sufficient	충분한
superficial	표면의, 천박한
tame	길들여진(이다)
tender	부드러운
thin	얇은
transient	일시적인
urban	도시의
valid	유효한
vertical	수직의
whimsical	변덕스러운
wistful	탐내는, 생각에 잠긴
wholesome	건전한, 유익한
ancestor	선조
ceremony	의식(행사)
consensus	(의견의 )일치
convenience	편리, 편의
dawn	새벽
defect	결점, 결함
degree	정도
descent	하강, 가계
disaster	재해
dominion	지배
eccentricity	별남, 기발
emigration	이주, 이민
evaluation	평가
fortnight 2	주간
incentive	동기
interior	내부(의)
lack	부족
liquid	액체
male	남성의
maximum	최대의
merit	장점
nephew	조카
obligation	의무
occupation	직업
ornament	장식(품)(하다)
pessimism	비관주의
predecessor	선배
prologue	서언, 머리말
prosecution	기소
range	범위
revenue	세입, 수익
ridicule	조소(하다)
synonym	동의어
theory	이론
thrift	검소, 검약
trend	경향
virtue	미덕
zeal	열심, 열중
wreck	난파(하다)
synthesize	종합하다
dispute	토론하다, 다투다
quote	인용하다
disperse	분산(발산)하다
lay off	해고하다
inhibit	억제하다
hand in	제출하다
quiver	떨다
juvenile	청년기의
fertile	기름진, 비옥한
ruthless	무자비한
hereditary	세습의, 유전의
inherent	타고난, 고유의
vague	모호한
even	짝수의
prevalent	유행하는, 퍼지는
horizontal	수평선의
demerit	결점, 단점
antonym	반의어, 반대말
epilogue	끝 맺음말
descendant	자손
whim	변덕, 일시적 기분
abound in	풍부하다
absorbed in -	에 빠져있는
abstain from	삼가다
accompany	동반하다
accord with -	와 일치하다
accuse	고발하다
accustomed to -	에 익숙한
acquainted with -	을 알고있는
adhere to	집착하다
afford to do	여유가 있다
ally	동맹시키다
apologize	사죄하다
apply	적용하다
ascribe	탓으로 돌리다
avail oneself of	이용하다
avoid	피하다
bestow	주다, 수여하다
beware of -	에 주의하다
charge	고발하다
cling to -	에 달라붙다
concentrate on	집중하다
consent to -	에 동의하다
consist in -	에 있다
consist of -	로 구성되다
consist with -	와 일치하다
consult	상담하다
contend with(against)	다투다
contribute to	공헌하다
cooperate with -	와 협력하다
cope with	처리하다
correspond with	펜팔 하다
correspond to -	와 일치하다
deprive	빼앗다
derive from -	에 유래하다
devote	바치다
differ from -	과 다르다
disappoint	실망시키다
discuss	의논하다
dispense with -	없이 지내다
dispose of -	을 처분하다
dissent from -	에 반대하다
distinguish	구별하다
dwell in -	에 살다
dye	물들이다
enforce	강제하다
entitle	자격을 주다
equip	갖추어 주다
exchange	교환하다
flatter	아첨하다
forbid	금지하다
forgive	용서하다
forsake	(습관을)버리다
furnish	공급하다
grateful	감사하고 있는
impose	부과(강요)하다
inclined to do	경향이 있는
indulge in -	에 빠지다
inflict	(벌을) 과하다
inform	알리다
inquire after	병 문안하다
inquire for	묻다
interfere with	방해하다
intrude into -	에 밀어 넣다
justify	정당화하다
laden with -	을 쌓아둔
mention	간단히 말하다
occupied in -	에 종사하는
owe	빚이 있다
partake in	참가하다
participate in	참여하다
persist in	고집하다
persuade	설득하다
possessed by(with) -	에 홀린
possessed of	소유하고 있는
prefer	더 좋아하다
preoccupied with	골몰한
presume	추정하다
provide	공급하다
reap	베다, 거두다
reckon	계산하다, 여기다
recognize	인정하다
reduce	줄이다
refer to	언급하다
refrain from	삼가다
regard	간주하다
with regard to	관하여
without regard to	무시하고
rely on	의존하다
replace	바꾸다
respond to	반응하다
revenge	복수하다
satisfy	만족시키다
steal	훔치다
submit	제출하다
submit to	복종하다
substitute	대리(대신)하다
succeed in	성공하다
succeed to	계승하다
suggest	제안하다
surrender to	항복하다
sympathize with	동정하다
transact with	거래하다
trespass on	침입하다
yearn for	동경하다
yield to	굴복하다
akin to	유사한
on the alert	경계하여
alien	외국의
aloof	떨어진, 멀어진
anxious about	걱정하는
anxious for	열망하는
apt to do	경향이 있는
ashamed of	부끄러워하는
aware of	알아차린
capable of	할 수 있는
certain	확신한
compatible with	양립할 수 있는
contrary to -	에 반하여
convenient	편리한
destitute of -	없는, 결핍한
devoid of -	이 결여된
due to do	예정이다
due to	(명) 때문에
equal to -	에 동등한
essential to -	에 필수적인
except for -	을 제외하고
famous for -	로 유명한
fertile	비옥한
frank	솔직한
indifferent to -	에 무관심한
intense	강렬한
intent on	몰두하는
lean against(on)	기대다
in particular	특별히
previous to -	에 앞서서
reluctant to do	마음이 없는
responsible for	책임을 지다
similar to -	을 닮다
weary of -	에 질린
weary with -	에 지친
as a whole	전체로서
on the whole	대략
in addition to -	에 더하여
take advantage of	이용하다
agent	대리인
make allowance for	고려하다
appeal to	호소하다
approach	접근하다
attribute	탓으로 돌리다
on the average	평균하여
in behalf of	대신하여
bent on	열중하고 있는
contempt	경멸
contented with	만족한
cure	치료하다
by degrees	서서히
despair of	절망하다
in detail	자세히
dignity	위엄
doomed to do	운명지어진
off(on) duty	비번(당번)으로
esteem	존경하다
to excess	과도하게
expense	비용, 지출
fancy	공상(하다)
find fault with	트집잡다
ask a favor of	부탁하다
in favor of	찬성하여
figure out	계산(이해)하다
fowl	새
guarantee	보증(하다)
do harm	해를 주다
in haste	서둘러서
justice	정의
for lack of	부족하여
at liberty	자유롭게
at a loss	난처하여
by all means	반드시
by means of -	에 의하여
prey on	잡아먹다, 괴롭히다
proof against	견딜 수 있는
reign	통치하다
relevance	관련, 적절
share	공유하다
by stealth	은밀히
in succession	연속하여
lose one's temper	화내다
on good terms with	사이 좋은
in token of -	의 표시로
trifle with	적당히 다루다
come to terms	화해하다
victim	희생자
by virtue of -	의 힘으로
bear witness to	증언하다
thirst for	갈망하다
side with	편이 되다
in reference to	관하여
a man of means	자산가
in addition to	더하여
put on airs	거드름 피우다
extracurricular	과외의, 일과 이외의
unreasonable	불합리한, 비이성적인
inconsistent	모순된
considerable	중요한, 상당한
carbohydrate	탄수화물
authorities	당국, 공사
relationship	관계, 친척관계
requirement	요구, 필요
devoted oneself	헌신하다, ~에 전념하다
exaggerate	과장하다
deliberate	신중한, 사려 깊은
be content with	~에 만족하다
comprehend	이해하다, 포함하다
extinction	소화, 종식
definitely	분명하게, 명확하게
traditional	전통적인
attractive	마음을 끄는, 매력적인
regardless	관심없는, 하여간
creativity	창의성, 독창성
figurative	상징적인
comfortable	편안한
acceptance	수납, 용인
excessive	과도한, 극단의
irregular	불규칙한
abundance	풍부함
reluctant	싫어하는, 내키지 않는
spreading	펴져 있는, 뻗은
essential	본질적인, 필수적인
pronounce	발음하다, 표명하다
tradition	전통, 전설
entertain	즐겁게 하다, 대접하다
reception	수령, 환영회
pollution	오염, 공해
politician	정치가
voluntary	자발적인, 임의의
formation	형성, 조립
desirable	바람직한, 호감이 가는
customary	습관적인, 통례의
priceless	아주 귀중한
insistent	강요하는, 뚜렷한
communication	통신, 보도
recognize	인정하다, 인지하다
concentration	집중, 농축
relevant	관련 있는
insufficient	불충분한, 부족한
immature	미숙한
in turns	차례로, 번갈아
conventional	전통적인, 틀에 박힌
available	쓸모 있는, 유효한
arrogant	거만한, 거드름 부리는
gorgeous	호화스러운, 멋진
escalate	차츰 오르다
numerous	다수의, 무수한
responsibility	책임
adequate	적당한, 적절한
pronunciation	발음(법, 기호)
flawless	흠 없는, 완벽한
direction	방향
confident	확신하고 있는
principal	주요한, 우두머리
accurate	정확한
exchange	교환(물)
for instance	이를테면
quantity	양
condense	응축하다, 요약하다
talented	재능있는, 유능한
catastrophe	참사, 재앙
backbone	등뼈, 산맥
contrast	대조, 대비(하다)
distinction	구별, 차이
preserve	보호하다, 보존하다
temperature	온도, 체온
imminent	절박한
furious	노하여 날뛰는, 맹렬한
workshop	작업장, 연수회
totally	전적으로, 완전히
mention	언급하다
association	협회, 연합
register	등록(하다)
deposit	맡기다, 예금하다
ambition	야망
toenail	발톱
psychologist	심리학자
advancement	진보, 승진
assembly	집회, 조립
context	문맥, 전후 관계
unbelievable	믿기 힘든
flooded	몰에 잠긴, 침수된
in fact	사실은
deserve	~할 만하다
discuss	검토하다
confirm	확인하다
process	진행, 처리하다
orderly	차례로 된, 정돈의
distant	먼
succeed	성공하다, 계승하다
continuous	계속적인
incredible	놀라운, 믿을 수 없는
hurtful	고통을 주는, 유해한
remarkable	두드러진, 현저한
payment	지불, 보수
confide	신임하다
observation	관찰, 관측
average	보통의
tremble	진동(하다), 흔들리다
curricular	교과 과정의
originality	진짜임, 독창력
compare	비교하다, 비유하다
adolescent	청년기의, 사춘기의
by request	요청에 따라
by mistake	실수로
connection	관계, 연결
neutral	중립의, 중립국
neglect	무시, 간과(하다)
supporting	지지하는
symptom	징후, 증상
succession	연속, 계승
compass	나침반, 범위
illegal	불법의, 불법입국자
accomplish	이루다, 달하다
quality	질(좋은), 우수성
forgive	용서하다, 면제하다
contest	경쟁, 다툼(하다)
pretend	~인 체하다
replace	제 자리에 놓다, 대신하다
permission	허가
laboratory	실험실, 연구소(의)
theater	극장, 극단
attract	끌다, 매혹하다
apology	사과, 변명
frugal	절약하는, 간소한
mortal	치명적인, 죽음에 이르는
polish	갈아 닦다, 광내다
generosity	관대함, 친절
disregard	무시하다, 소홀히 하다
funeral	장례식(의)
logical	논리상의, 필연적인
qualified	자격이 있는, 적격의
proceed	나아가다
undermine	훼손하다, ~의 밑을 파다
dialect	사투리
integrate	통합하다, 완전하게 하다
modify	수정하다, 변경하다
statue	상
require	요구하다
refuse	거절하다
in person	자기 스스로, 본인이 직접
extension	넓힘, 연장
regarding	~에 대해서는
endurance	지구력, 인내
faulty	결점이 있는, 그릇된
voyage	항해, 여행
nutrition	영양물, 자양
physician	내과의사
sanctuary	성역
organized	조직화된, 체계화된
animation	생기, 만화영화
arrest	체포하다
cavity	움푹한 곳, 충치
hatred	미움, 혐오
appreciate	고맙게 생각하다, 감상하다
tablet	정제
technical	기술의, 숙달된
globalism	세계적 규모화
repair	고치다
quarterly	일년에 네 번 발생하는
attention	주의, 배려
compromise	타협(하다)
routinize	규칙화하다, 관례화하다
belief	믿음, 신뢰
promotion	승진, 판촉
sitcom	시트콤
attach	붙이다, 가입시키다
fierce	흉포한, 격렬한
square	정사각형(의), 공정한
courteous	예의바른, 친절한
uphold	받치다, 지지하다
breast	가슴, 젖주다
endure	견디다
charge	장전, 청구하다
debate	토론, 논쟁(하다)
invade	침해하다, 습격하다
reference	위탁, 참조
flavor	맛(을 내다), 풍미(를 더하다)
retire	은퇴하다, 물러가다
frustrate	좌절시키다, 무효로 하다
copper	구리(의), 구리를 입히다
starve	굶주리다, 갈망하다
cowardly	겁쟁이의, 비겁한
pleasant	기분좋은, 유쾌한
opponent	적, 적수
female	여성(의)
pay attention to	~에 주의를 기울이다
supply and demand	공급과 수요
statement	표현, 진술
directory	지휘의, 전화번호부
classify	분류하다, 등급을 나누다
autograph	자필서명(의)(하다)
breath	호흡
refund	환불, 상환(하다)
alienate	멀리하다, 양도하다
revise	개정하다
intend	의도하다
character	특성, 문자, 기호
translate	번역하다
advertise	광고하다
existent	실재하는
scared	겁먹은
reserved	수줍은, 보류한
attend	출석하다, 주의하다
create	창조하다
revision	개정, 수정(판)
desire	요구, 갈망(하다)
deserted	사람이 살지 않는, 황폐한
refer to	~을 언급하다
favorite	마음에 드는, 좋아하는 것
merit	장점, 공적
supplier	공급자
harsh	거친, 엄한
blend	섞다, 혼합하다
obstacle	장애, 방해(물)
vapor	증기, 망상
crude	천연 그대로의, 조잡한
legal	합법적인, 법률상의
state	말하다, 진술하다
usual	보통의, 일반적인
bless	축복하다
fancy	공상, 상상(의)(하다)
treasure	보물, 소중히 하다
nutrient	영양소(의), 자양이 많은
prudent	조심성 있는, 분별 있는
obscure	분명치 않은, 불명료한
conflict	투쟁, 충돌(하다)
deceive	속이다, 기만하다
applaud	박수치다, 칭찬하다
negative	부정(의)
corrupt	타락시키다, 부패시키다
cruel	잔혹한, 지독한
immense	거대한, 광대한
flour	밀가루, 가루로 빻다
annoy	성가시게 굴다, 괴롭히다
pastoral	전원생활(의)
tight	빈틈 없는, 단단한
specific	명확한, 특성
robbery	강도, 약탈
issue	발행(하다), 논쟁점
slave	노예(의)
widower	홀아비
shore	물가, 해안
widow	미망인(이 되게 하다)
equip	준비하다, 장비하다
landmark	경계표
trash	쓰레기
capital	수도
element	원소, 성분
rough	거친, 거칠게(다루다)
erase	지우다
trunk	트렁크, 간선의
sweat	땀(흘리다), 노동(하다)
queue	줄(서다)
expense	비용
greed	탐욕
paste	풀, 붙이다
produce	생산하다
swing	흔들다, 스윙
propose	제안하다
self-confident	자부심의
idiom	관용구, 숙어
be engaged in	~에 종사하다
leading	이끄는, 지도
depth	깊이, 중대함
offer	제공, 제안(하다)
crazy	미친, 괴짜
release	풀어놓다, 공개(하다)
guess	추측(하다)
order	명령, 주문(하다)
journey	여행, 행로
worth	~할만한, 가치
trivial	사소한, 평범한
violent	격렬한, 폭력적인
article	기사, 품목
survive	생존하다
reserve	보존하다, 보존, 예비의
regard A as B	A를 B로 간주하다
nowhere	미지의 장소, 아무 데도~없는
unusual	비범한
uncomfortable	거북한, 불편한
request	요청(하다)
lose the game	경기에서 지다
receipt	영수(증)
pay attention	주의하다, 집중하다
monster	괴물, 거대한
launch	진수, 발진
quarter	4분의 1(의)
confuse	혼동하다, 혼동시키다
oversea	해외의, 해외로
patient	환자, 참고 견디는
respond	반응하다
suicide	자살(하다)
treaty	조약, 맹약
barren	불모의
routine	일상의(일)
reject	거절하다, 거부하다
thrift	절약, 검약
merely	그저, 단지
hero	주인공, 주요 인물
branch	가지
forbid	금하다, 방해하다
shadow	그림자, 암시
poet	시인
vast	광활한, 넓은
logics	논리학
origin	기원, 유래
entertainment	환대, 오락, 연예
wise	현명한, 슬기로운
notify	통지하다, 신고하다
manage	그럭저럭 해 나가다
effect	결과, 영향
revive	부활하다
ride	타다, 승마, 승차
acknowledge	인정하다, 감사하다
prestigious	이름 난, 세상에 알려진
flea	벼룩, 귀찮은 녀석
feeble	연약한, 희미한
affirmative	긍정의, 단정적인
transparent	투명한, 비치어 보이는
maze	미로, 당황
settle down	정착하다, 가라앉다
priest	성직자(로 만들다)
recite	암송하다, 말하다
unique	독특한, 훌륭한(것)
spectacular	구경거리의, 눈부신
formal	형식적인, 정식의
degree	정도, 등급
weed	잡초(를 뽑다)
aspire	열망하다, 동경하다
assign	할당하다, 지정하다
reward	보상(하다), 현상금
cure	치료(하다), 치료제
export	수출(의)(하다)
firm	굳은, 단단히, 회사(법률사무소)
organization	조직, 구성, 협회
carton	판지상자(에 넣다)
sensibility	감각력, 감수성
script	필적, 대본, 대본을 쓰다
peer	동료, 응시하다
fair	공정한, 아름다운, 박람회
hate	증오(하다)
wrap	싸다, 포장지
planet	행성
effort	노력
bite	물다, 한 입
achievement	업적, 성공
notice	주의(하다)
principally	주로, 대개
bright	빛나는
consequence	결과, 중요성
proper	고유의
talent	재능
consist of	~로 구성되다
appropriate	충당하다, 적당한
give birth	낳다
infer	추론하다, 암시하다
react	반응하다, 응답하다
impediment	방해, 지장
provincial	한 지방의, 편협한
frustrated	실망한, 욕구불만의
nerve	신경, 담력
popularity	인기, 유행
manuscript	원고, 육필의
blank	공백의
board	판자, 타다
unfamiliar	낯선, 생소한
depression	억압, 불황
preference	더 좋아함, 우선권
communicate	통신하다
showy	눈에 띄는, 화려한
invitation	초대
charm	매력, 매혹하다
vowel	모음(의)
sting	찌르다, 찌름
awake	눈뜨다, 정신차린
drain	배수(하다), 빼앗다
transplant	이식, 이주(하다)
worse	더욱 나쁜, 더욱 나쁘게
immigrate	이주하다, 이민오다
piety	경건, 신앙심
vomit	구토, 분출(하다)
weightless	무게가 없는, 무중력의
shade	그늘(지게 하다), 차단하다
canal	운하(만들다), 만
flood	범람(하다), 넘치다
commercial	광고방송(의), 상업상의
float	뜨다, 부유물
smart	재빠른, 영리한
execution	실행, 사형집행
elementary	기초의, 초등의
clone	생명복제(하다)
brief	간결한, 적요, 요약하다
originate	일어나다, 기원하다
journalist	언론인
draft	초안, 징병(하다)
signature	서명
discourage	낙담하다, 낙담시키다
secretary	비서, 장관
encourage	용기를 북돋우다
influence	영향을 미치다
throughout	온통, ~내내
efficient	능률적인, 유효한
influenza	유행성 감기
evaporate	증발하다, 사라지다
emergency	비상사태, 긴급한
pass away	떠나다, 죽다
encircle	둘러 싸다, 일주하다
mild	상냥한, 순한
abundant	풍족한, 많은
copyright	저작권(의)(으로 보호하다)
maintain	유지하다, 부양하다
commonly	일반적으로
abnormal	비정상적인, 예외적인
meditate	묵상하다, 명상하다
addicted	중독된
in order	정리가 된, 정상인
slim	날씬한
courtesy	예의, 공손
miserable	불쌍한(사람)
invasion	침입, 침해
bend	구부리다, 숙이다
technique	기교, 기술
nauseous	구역질나는, 불쾌한
hug	포옹(하다)
starfish	불가사리
tear	찢다
associate	연상, 관련(하다)
otherwise	그렇지 않으면
pay	지불(하다)
situation	위치
task	임무, 과제
response	응답, 반응
creature	창조물, 생물
decision	결정, 결단력
politics	정치, 정치학
reviewal	재검토, 평론
cast	던지다, 배정하다
vain	공허한, 허영심 많은
bald	대머리의, 단조로운
definite	한정된, 명확한
lazy	게으른, 굼뜬
bury	매장하다
soil	흙, 대지
apparent	뚜렷한, 명백한
deadline	마감시간
vertical	수직의, 수직선
hell	지옥
dispute	논쟁, 분쟁
ceremony	의식(행사)
violence	폭력, 맹렬
yell	소리치다, 외침
certify	증명하다, 인증하다
rude	버릇없는
back up	후원하다, 지지하다
present	현재, 선물
lunatic	미친, 정신병자
meaning	의미, 취지
inhibit	억제하다, 금하다
decrease	감소(하다)
form	형성(하다)
hurt	상처, 고통(주다)
qualify	~에게 자격을 부여하다
possess	소유하다, 점유하다
exclaim	외치다, 소리지르다
journal	정기 간행물
terrify	겁나게 하다
specify	열거하다, 상술하다
painful	아픈, 고통주는
garment	의복
kingdom	왕국, 왕정
prevent	막다, 예방하다
charity	박애, 자비
outline	윤곽, 개요(를 잡다)
account	기술, 거래, 설명하다
nervous	신경질적인, 불안한
decline	쇠퇴(하다), 거절하다
stomach	위, 배
brutal	잔인한, 야만의
innate	타고난, 천부의
besides	~외에도, 게다가
express	표현하다, 명확한, 급행(의)
include	포함하다
arrange	배열하다, 조정하다
dim	어둑한, 흐릿한
depress	낙담시키다
secure	안전한, 안정된
assume	추정하다, 가정하다
tariff	관세
suggest	제안하다
vacate	비우다, 사직하다
worsen	더 악화시키다, 더 나쁘게 하다
emerge	나타나다, 빠져나오다
eraser	지우개
locate	~의 위치를 정하다
margin	여백, 가장자리
relate	이야기하다, 관련시키다
wander	헤매다
abroad	해외로
differ	다르다, 달리하다
tumble	재주넘다, 전도
row	열, 노젓기, 노젓다
stripe	줄무늬, 종류
fur	모피
powder	가루, 분말(로 만들다)
regard	응시, 간주(하다)
vacant	빈, 멍한
sudden	돌연한, 별안간의
odd	이상한, 홀수의
valley	골짜기, 계곡
orphan	고아(로 만들다), 부모가 없는
rhythm	리듬, 율동
muscle	근육
empire	제국, 절대 지배권
client	의뢰인, 단골
tap	가볍게 두드리다, 마개
shy	수줍은, 부족한
starry	별이 많은, 별 같이 빛나는
temple	절, 사원
ash	재(뿌리다)
normal	표준, 정상(의)
dot	점(찍다)
tender	연한, 부드럽게 하다
common	공통의, 보통의
secret	비밀(의)
desert	사막(같은), 버리다
survey	전망, 조사(하다)
recent	최근의
decide	결심하다
figure	형태, 계산하다
seldom	드물게
accept	받아들이다
sweep	쓸다, 일소하다
twist	꼬다, 비틀다
blunt	무딘, 둔감한
sight	시각, 볼거리
value	가치
media	medium의 복수형
bunch	송이, 다발
curse	저주, 재앙(하다)
stump	그루터기
fiber	섬유, 근성
layer	층(을 만들다)
trick	속임수(의)(하다)
timid	겁 많은, 소심한
empty	빈, 비우다
frail	깨지기 쉬운
trust	신임, 신뢰(하다)
favor	호의, 친절(하다)
heap	쌓아 올리다, 축적하다
jury	배심, 배심원
mill	제조공장, 제분소
loss	손해
lack	부족하다
ruin	파멸, 멸망(시키다)
moth	나방
claw	발톱(으로 할퀴다)
wage	임금, 유지하다
deck	갑판(을 대다)
sigh	한숨(쉬다), 탄식(하다)
palm	손바닥
flaw	흠(잡다), 결함, 무효화하다
text	원문, 주제
melt	녹다, 녹이다
cart	짐수레, 손수레
curl	곱슬(거리게 하다)
site	대지, 현장
cave	동굴
neat	산뜻한, 교묘한
hire	고용(하다)
huge	거대한
cane	지팡이, 매질하다
aid	도움, 원조
tow	끌다, 끌어당기다
fog	안개
tin	주석(의)
tip	끝, 팁(을 주다)
sew	바느질하다, 꿰매 맞추다
capture	포획, 생포(하다)
profession	전문직
pay back	되갚다
skip	건너뛰다, 건너뜀
cope with	견디어 내다
animate	생기를 불어 넣다, 생기 있는
define	정의를 내리다, 한정하다
mean	야비한, 의미하다
distinguish	구별하다, 구분하다
praise	칭찬, 찬미(하다)
within reach of	~의 손이 닿는 곳에
deadly	치명적인, 죽은 듯이
contend	싸우다, 항쟁하다
aboard	탑승하여, 타고
tighten	죄다, 팽팽하게 하다
thumb	엄지손가락
share	몫, 주식, 공유하다
possession	소유, 소유물
rinse	헹구다, 헹굼
milestone	이정표, 획기적 사건
chop	자르다, 찍다
incident	사건
wire	전선, 배선하다
rarely	드물게
audience	청중, 관객
drainage	배수(설비), 하수
robber	강도, 약탈자
replace A with B	A를 B로 대체하다
religion	종교, 신조
example	예, 보기
doubt	의심, 불신(하다)
injury	상해, 손상
believe	믿다, 신뢰하다
fact	사실, 진상
rare	드문
terrific	굉장한, 무서운
dense	빽빽한, 짙은
shortcoming	단점
connect	연결하다
performance	실행, 연기
clown	광대(짓하다)
scarce	부족한, 진귀한
poetry	시, 시집
horizen	지평선, 수평선
at one's desire	희망대로
sensibly	현저히, 분별 있게
stamp	날인(하다), 우표
make up	구성하다, 화장하다
fantastic	공상적인, 멋진
be filled with	~로 가득 차다
apart	별개로
ask for	요구하다
blessing	은총
design	디자인, 기획(하다)
calculate	계산하다, 추정하다
jewelry	보석류
consistent	일치한, 견실한
frighten	놀라게 하다
workplace	일터, 작업장
excuse	변명, 사과(하다)
extraordinary	특별한, 비범한
cooperate	협력하다, 협동하다
more or less	다소, 얼마간
sincere	성실한, 진실의
doublt	의심
honesty	정직
factory	공장
architect	건축가, 설계자
deceased	사망한, 고인의
foster	돌보다, 애정을 주는
sorrow	슬픔, 슬퍼하다
blossom	꽃(피다), 만발(하다)
insist	고집하다, 주장하다
impression	인상, 감상
fable	우화, 신화
equipment	준비, 장치
bead	구슬(장식하다)
describe	묘사하다
herb	허브, 식용 식물
shrink	줄어들다, 겁내다
merchant	상인, 상업의
agitate	휘젓다, 선동하다
executive	행정부(적인), 관리직(의)
flexible	구부리기 쉬운, 융통성 있는
grain	곡류
foolish	어리석은, 창피한
aerobic	호기성의, 에어로빅스의
relation	관련, 진술
surface	표면(의)
orphanage	고아원, 고아임
norm	표준, 규범
ban	금지(하다)
aspiration	포부, 열망
disaster	재앙, 재난
impartial	공평한, 편견이 없는
convert	변화하다, 귀의자
spread	펴다, 유포
hinder	방해하다, 뒤의
immediate	즉각의, 인접한
wizard	마법사, 마법의
daybreak	새벽
clap	박수(치다)
thrifty	검약하는, 무성한
stick	붙다, 찌르다, 막대기
generous	관대한, 풍부한
knight	기사, 기사작위를 주다
regional	지역의, 지방의
exist	존재하다, 생존하다
informal	비공식적인, 약식의
compact	소형의, 간결하게 하다, 콤팩트
tame	길들인, 길들이다
ashore	해안에, 육상에
dull	둔한, 둔하게 하다
horizontal	가로의, 수평의
indeed	정말로, 실은
envious	시기심이 강한, 질투하는
protein	단백질(의)
situate	위치를 정하다, 놓다
vow	맹세, 공약(하다)
indict	기소하다, 나무라다
evil	사악(한)
glimmer	희미한 빛
satisfy	만족시키다, 충분하다
prevention	저지, 예방법
smooth	매끄러운, 평탄하게 하다, 평지
direct	지도하다, 가리키다
appeal	애원, 호소(하다)
flat	평평한, 평면
neutralize	중립으로 하다, 중성으로 하다
upset	전복(시키다), 엉망인
savor	풍미, 흥미
fright	공포, 경악
rotate	회전하다, 교체하다
popular	인기 있는, 대중적인
lunar	달의, 태음의
youth	젊음, 청년
species	종, 인류
utilize	이용하다
ancient	옛날의, 오래된
astronomy	천문학
curve	구부리다
structure	구조, 구성(하다)
cause	원인, 이유(이 되다)
location	위치, 야외 촬영지
bold	대담한, 굵은
Venus	비너스, 화성
exhibition	전람, 공개
attraction	끌어당김, 매력
honor	명예, 존경하다
rational	이성적인, 분별있는
successful	성공한
luxurious	사치한, 호화스러운
suppose	추측하다
ethical	도덕적인, 윤리상의
supply	공급(하다)
tale	이야기
constant	일정한
creative	창조적인
correct	옳은, 고치다
superior	뛰어난, 보다 나은
rub	문지르다, 마찰
architecture	건축술, 건축학
broadcast	방송하다
in favor of	~에 찬성하여
fringe	가장자리, 변두리
astonish	깜짝 놀라게 하다
insurance	보험
attempt	시도(하다)
successive	계속적인, 연속하는
loud	시끄러운, 큰소리로
boundary	경계, 한계
rise	상승(하다)
term	용어, 기간
relax	늦추다, 풀리다
momentary	잠시의, 덧없는
passive	수동적인
feast	축제, 향연
exhibit	전시(하다)
honorable	존경할 만한, 고귀한
distance	거리, 간격
assemble	모으다, 조립하다
product	생산품
in excuse of	~의 변명으로서
temperate	절제하는, 온건한
although	~이기는 하지만
stretch	넓히다, 늘이다
advanced	진보한
review	평론(하다)
terror	공포, 두려움
amount	금액이 ~되다, 총액
consumption	소비
effective	유효한
enemy	적
concentrate	집중하다
apologize	사과하다, 사죄하다
show	보여주다, 쇼
dictator	독재자
medium	중간, 중간의
intention	의지, 목적
proud	자랑하는
moderate	적당한, 보통의
cope	맞서다
active	활동적인, 적극적인
demand	요구, 청구(하다)
clumsy	눈치 없는, 서투른
perform	수행하다
rent	임대하다
achieve	이루다
opinion	주장
monstrous	괴기한, 괴물같은
lavish	아끼지 않는, 사치스러운
promote	장려하다
astonishing	놀라운, 눈부신
instance	예, 보기(를 들다)
fantasy	상상, 공상문학 작품
custom	관습, 맞춤의
resist	반항하다, 저항하다
prefer	~을 더 좋아하다
regular	질서정연한, 보통의
extra	여분의, 특별한(것), 특별히
dead	죽은
legacy	유산, 유증
plow	쟁기, 갈다
consume	소비하다, 소모하다
familiar	익숙한, 친밀한
be scant of	~이 부족한, ~이 결여된
convenient	편리한
ambiguous	모호한, 확실치 않은
adventure	모험, 위험을 무릅쓰다
Arctic	북극지방의, 북극
spirit	정신, 영혼
gracious	품위 있는, 친절한
heaven	하늘, 천국
evident	분명한, 명백한
either	어느 한 쪽(의)
rubber	고무
focus	초점(맞추다)
blizzard	눈보라, 폭풍설
quickly	빠르게
tough	질긴, 불굴의
sensitive	민감한, 예민한
global	세계적인, 구형의
figure out	해결하다, 이해하다
brave	용감한(하다), 용사
keep up with	뒤지지 않다, 따라가다
roam	배회(하다)
vehicle	탈 것
rate	비율, 평가하다
productive	생산적인, 생산하는
pollute	요염시키다
solitary	혼자의, 외로운
ill	고난, 병(의), 나쁘게
dairy product	유제품
garbage	쓰레기
misery	고통, 비탄
imitate	모방하다
vertically	수직으로, 직각으로
delicious	맛있는
semester	반년간, 학기
deliver	배달하다, 넘기다
overseas	해외의, 해외로
spur	박차를 가하다, 자극하다
support	지탱, 원조(하다)
underestimate	과소평가하다, 경시하다
argument	논증, 말다툼
provide	공급하다
endeavor	노력하다, 애쓰다
increase	증가(하다)
unify	통일하다
shed	흘리다, 떨어지다
refer	조회하다, 언급하다
political	정치적인, 정략적인
volunteer	지원자(의)(하다)
cabinet	내각
difference	다름
data	자료, 정보
wounded	다친
typical	전형적인
stomachache	위통, 복통
spill	엎지르다, 유출
prejudiced	편파적인, 불공평한
regret	후회(하다)
verify	입증하다, 확증하다
suppress	억압하다, 금지하다
correction	수정, 첨삭
wisdom	지혜
drawback	결점, 장애
pain	고통(주다)
immerse	담그다, 열중시키다
grade	등급, 학년
worthy	가치 있는, 훌륭한
discover	발견하다
be about to	막 ~하려 하다
leisure	자유시간, 여가(의)
apart from	~은 별도로
philosophy	철학
in charge	책임지고 있는
neither A nor B	A, B 둘 다 아니다
journalism	저널리즘, 언론
be eager to	~에 간절히 열망하다
rather	오히려, 상당히
policy	정책, 방침
boast	자랑하다, 뽐내다
tremendous	놀라게 큰
conceal	은닉하다, 숨기다
bill	계산서, 지폐
ability	능력
consider	간주하다, 고려하다
calculation	계산, 예상
reliable	믿을 수 있는
defect	결점, 흠
illogical	비논리적인
pollutant	오염물질
extensive	넓은, 대규모의
pill	알약(으로 만들다)
twinkle	반짝이다, 빛남
consequently	결과적으로, 따라서
advertisement	광고, 통지
sparkle	불꽃(을 튀기다)
bitter	쓴, 고통스러운
thin	여윈
various	다양한
dye	염료, 물들이다
embrace	포옹하다, 껴안다
commerce	상업, 교역
courage	용기, 담력
slender	호리호리한
scary	겁 많은
obstruction	방해, 장애(물)
registration	기재, 등기 우편
gradually	차차
curious	호기심이 강한
recently	요즈음
saint	성인, 군자
employee	종업원
income	수입
appetite	욕망, 기호
carry out	실행하다
habitat	서식지, 거주지
indifferent	무관심한, 중립의
temporary	일시적인, 잠시의
loosen	늦추다
slum	빈민굴
though	~이기는 하지만
scholarship	학문, 장학금
avoid	피하다
proportion	비율, 균형
aloud	소리 내어, 큰 소리로
impact	충격, 강한 영향을 주다
match	짝, 경기, 필적하다
greedy	탐욕스러운
labor	노동(력)
suitable	적합한, 어울리는
phychology	심리학
handicapped	심신 장애의
attendant	수행원, 출석한
arrangement	정돈, 협정
attendance	출석, 시중
religious	종교의, 겅건한
contain	포함하다
mission	사절, 사명
foreign	해외의
pass the exam	시험을 통과하다
procedure	진행, 절차
incorrect	부정확한
heroine	여걸, 여주인공
inquire	묻다, 조사하다
bear	낳다, 참다
mess	혼란, 망쳐 놓다
wreck	난파(시키다)
destroy	파괴하다
declare	선언하다, 신고하다
fix	고치다, 확정하다
fat	지방
occur	발생하다, 머리에 떠오르다
nurture	기르다, 영양공급하다
cathedral	대성당
utility	유용, 효용
complain	불평하다, 호소하다
execute	실행하다, 처형하다
pressure	압력, 압박(을 가하다)
permit	허가하다
marginal	주변의, 한계의
unless	~이 아니면, ~을 제외하면
rip	찢다, 찢음
moderation	알맞음, 중용
local	지방의, 장소의
gravity	중력, 엄숙함
compassionate	동정심 있는
observe	관찰하다, 준수하다
region	지방, 영역
burden	부담(지우다)
astrology	점성학, 점성술
expedition	탐험대, 원정여행
considerate	이해심이 있는, 생각이 깊은
brain	두뇌, 지력
popularize	대중화하다, 보급시키다
wig	가발 장식
import	수입(하다)
surround	둘러싸다, 환경
normalize	표준화하다, 정상화하다
selfish	이기적인
fleamarket	벼룩시장
discriminate	구별하다, 차별하다
organize	조직하다, 정리하다
thrive	번성하다, 번영하다
novel	소설, 새로운
rhyme	압운(을 맞추다), 시를 짓다
jealous	질투심 많은
bough	큰 가지
poem	시
ape	유인원, 흉내내다
channel	해협, 채널, 수로를 열다
factual	사실에 입각한
calm	고요(한)(하게 하다)
meter	계량기(로 재다), 미터
shout	외치다, 환호(하다)
uniform	제복
sensible	분별있는, 느낄 수 있는
qualification	자격부여, 면허
preview	예습, 시사회(하다)
vanity	허영심, 허무함
impress	날인(하다), 인상을 주다
argue	논쟁하다
preservation	보존, 보호
adolescence	사춘기
curiosity	호기심
chore	허드렛일
fingernail	손톱
duty	의무
reach	도달하다, 세력범위
crossroad	교차로
organ	자기, 기관
responsible	책임 있는
establish	설립하다, 제정하다
environment	환경
comparison	비교, 유사
run out of	다 써버리다, 바닥나다
spice	양념, 풍미
extent	넓이, 범위
stingy	인색한, 톡쏘는
loyal	충성스러운, 애국자
complicated	복잡한
gleam	번득임, 번득이다
absurd	불합리한, 터무니없는
envy	질투, 선망(하다)
fixed	고정된, 확고한
alien	외국인(의), 외래의
marine	바다의, 항해의
horizon	지평선
rob	강탈하다, 빼앗다
essence	본질, 정수
wholesome	건전한, 신중한, 안전한
accordingly	따라서, 그러므로
fragment	파편, 부서지다
abrupt	뜻밖의, 돌연한
fold	접다, 포개다, 주름
fault	결점, 실수
decent	예절바른, 상당한
seize	붙잡다, 꽉 쥐다
advance	나아가게 하다, 촉진시키다
drip	똑똑 떨어지다, 똑똑 떨어짐
magnet	자석, 자철
bug	곤충(잡다), 버그
spoil	더럽히다, 상하게 하다
unforgettable	잊을 수 없는
forecast	예상, 예보(하다)
artificial	인공의, 모조물
cherish	소중히 하다, 품다
intelligence	이성적인, 지적인
nightmare	악몽, 가위눌림
misuse	오용하다, 잘못 사용하다
permanent	영속하는, 불변의
destruction	파괴, 파멸
swallow	마시다, 삼킴, 제비
fatal	치명적인
put up with	~을 참다
recipe	조리법, 처방
nod	끄덕(이다), 명령(하다)
soak	적시다, 흡수하다, 담금
mental	마음의, 정신적인
meadow	목초지
conversion	전환, 개조
taboo	금기(의)(하다)
press	누르다, 인쇄
mosquito	모기
consonant	자음, ~와 일치하는
poison	독(을 넣다)
survival	생존(의), 생존자
opportunity	기회
province	주, 영역
raw	날것(의), 미숙한
prohibit	금하다, 방해하다
nausea	메스꺼움, 혐오
spicy	양념을 넣은, 흥취있는
insult	모욕(하다)
admire	감탄하다
publish	발표하다, 발행하다
mend	수리하다, 고치다
awkward	어색한, 서투른
description	묘사, 설명
portrait	초상(화), 생생한 묘사
merchandise	상품, 매매하다
noodle	국수
anywhere	어디에나
loose	풀린, 느슨하게
bud	싹(트다)
wipe out	지우다
murder	살인, 살해하다
creep	기다, 살며시 들어가다
airtight	밀폐된, 빈틈 없는
pity	동정(하다), 유감스러운 일
partial	일부분의, 불공평한
stubborn	완고한, 고집 센
fabulous	전설상의, 거짓말같은
professional	전문의, 전문직업가
distinct	별개의, 뚜렷한
rotten	썩은
solution	해결, 용해
show off	뽐내다, 자랑하다
at the moment	지금, 현재
medial	중간의, 보통의
break down	고장나다, 무너지다
mass media	대중 전달 매체
unable	불가능한
by the medium of	~을 통해서
exceptional	예외적인, 특별한
mainly	주로
rigorous	엄격한, 혹독한
chief	우두머리, 주요부
tiny	작은, 조그마한
moral	도덕의, 교훈적인
raft	뗏목(을 엮다, 으로 건너다)
rescue	구조하다, 구출하다
genius	천재, 비범한 재능
wipe	닦아 내다, 닦음
suggestion	연상, 제안
autobiography	자서전
amount to	총계가 ~에 달하다
original	최초의, 고유의
properly	적당히, 올바르게
prevailing	세력있는, 유행하는
result	결과, 성과
flee from	~로부터 도주하다, 도망가다
confidential	기밀의, 신임이 두터운
devise	궁리하다, 고안하다
confidence	신임, 신뢰
adopt	채택하다, 입양하다
concentrative	집중적인, 골몰하는
shortcut	지름길
acceptable	받아들일 수 있는
silly	어리석은
mere	단순한, 보통의
surgeon	외과의사
trap	덫, 덫으로 붙잡다
cultivate	경작하다, 재배하다
antonym	반의어
due to	~때문에, ~덕분에
cancer	암, 게자리
pride	자존심, 만족
means	방법, 수단, 재산
dizzy	어지러운, 현혹시키다
represent	나타내다, 대표하다
mutual	상호간의, 공동의
particular	특별한, 상세
cute	귀여운, 영리한
comb	빗(질하다)
breathe	숨쉬다, 호흡하다
injure	상처를 입히다, 손상시키다
trace	자취, 밝혀내다
despise	경멸하다, 혐오하다
flame	불꽃, 화염
receive	받다
defer	연기하다, 미루다
lean	기대다, 경사, 여윈
aquatic	물 속의, 수생 생물
extinct	단절된, 멸종된
deter	그만두게 하다, 단념시키다
volcano	화산, 분화구
interpret	해석하다, 통역하다
deny	부정하다, 거절하다
preach	설교하다, 전도하다
spectacle	광경, 장관
consist	~으로 이루어져 있다, 공존하다
extend	펴다, 연장하다
common sense	일반 상식
telephone directory	전화번호부
guilty	유죄의, 저지른
extravagant	낭비하는, 지나친
be covered with	~로 덮여 있다
either A or B	A, B 둘 중 하나
substitute B for A	A를 B로 대체하다
thru the medium of	~을 매개로
make up for	보상하다, 보충하다
immigrate	이주시키다
impatient	참을성 없는
imply	함축하다, 암시하다
import	수입(하다)
impose	부과하다 impose A on B : B에게 A를 부과하다, 지우다
impress	감동시키다
improve	향상하다, 향상시키다
impulse	충격, 자극
incentive	자극적인, 자극
incident	: 사건
include	포함하다
income	수입
incomplete	불완전한
increase	증가(하다)
incredible	믿을 수 없는
independent	독립심이 강한
indicate	지시하다, 나타내다
indifferent	무관심한
indispensable	필수의, 꼭 있어야 하는
individual	개인의, 각각의 개인
industry	산업
inevitable	피할 수 없는
infamous	악명 높은
infant	유아
infect	감염시키다
infer.. from ~	..을 ~로부터 추론하다
be inferior to~	~보다 열등하다
infinite	무한한, 막대한
inflation	통화 팽창
inflict.. on ~	..을 ~에게 입히다
abandon	버리다, 포기하다
abide by~	~을 지키다
able	할 수 있는, 능력 있는 be able to
abnormal	비정상적인
abolish	폐지하다, (=do away with~)
abound in~	~이 풍부하다
absence	결석, 부재
absolute	절대의, 전적인 absolutely: 전적으로
absorb	흡수하다
absurd	부조리한, 불합리한
abundant	풍부한
abuse	남용하다, 학대하다, 남용, 학대
academic	학구적인, 학원의
accept	받아들이다, 수락하다
abstract	추상적인, 요약하다
access to ~	~에 대한 접근
accompany	동반하다, 수반시키다
accomplish	성취하다, 이루다
account	계산, 이유, (for~: ~을 설명하다)
accumulate	쌓다, 모으다, 축적하다
accuracy	정확성
accuse ... of ~	..을 ~로 비난하다
ache	아프다, 아픔
achieve	이루다, 달성하다
acknowledge	인정하다
acquaint .. .with ~	...에게 ~을 알리다
acquire	얻다, 습득하다
act	행위, 조례. 행동을 하다
activate	활성화하다
acute	날카로운, 민감한
adequate	충분한
adapt	적응시키다,
adhere to~	~에 집착하다
adjust to~	~에 적응하다
admire	찬탄하다, 칭찬하다
admit	인정하다, 시인하다
adolescent	청소년기(의)
advance	진보하다, 진보, in advance: 미리
advantage	이익, 우세
adventure	모험
adverse	반대의
advertize	광고하다
affect	영향을 미치다,
adopt	채택하다, 양자로 삼다
affection	애정
affirmative	긍정적인
afford to ~	~할 수 있다
aggressive	공격적인
agriculture	농업
aid	도움, 원조, 돕다
alarm	놀라게 하다, 경보
alert	방심 않는
allergic	알레르기의 (to~)
allow	허락하다 allow 목적어 to R~
alter	개조하다, 바꾸다
altitude	고도, 높이
ambition	야망
amaze	놀라게 하다
amount	총계, 양, 총계가 .. 에 달하다
amuse	즐겁게 하다
analyze	분석하다
ancestor	조상
announce	알리다, 발표하다
annoy	괴롭히다, 짜증나게 하다
anticipate	예상하다, 기다리다,
anxiety	걱정
apologize	사과하다
apparent	확실한
appeal to~	~에게 호소하다
appear	나타나다, ~처럼 보이다
appetite	식욕
apply	for~: ~에 지원하다, to~: ~에 적용되다
appointment	약속
appreciate	감상하다, 감사하다
appropriate	적절한
approach	접근하다, 다가가다
approve	승인하다, 찬성하다
approximate	대략의, 근접한
aptitude	적성
argue	논쟁하다, 주장하다
arise	일어나다, 생기다
arrange	정리하다, 조정하다
arrest	체포하다
arrogance	거만함
article	기사, 조항
artificial	인공의, 인위적인
be ashamed of~	~을 부끄러워하다
aspect	관점, 양상
assume	추측하다, assumption: 가정
assure	안심시키다
astonish	놀라게 하다
astronomy	천문학
athlete	운동선수
atmosphere	대기, 분위기
attach	붙이다 attach A to B: A를 b에 붙이다
attack	공격하다
attend	출석하다, 시중하다
attempt	시도(하다)
attitude	태도
attract	끌어당기다, 마음을 끌다
audience	청중, 관중
author	작가
autograph	자필, 사인
automatic	자동의
automobile	자동차
available	이용할 수 있는, 손에 넣을 수 있는
average	평균(의)
avoid	피하다
be accustomed to~	~에 익숙하다
alternative	대안, 양자 택일
awaken	깨우다, 자각시키다
aware	알고 있는 be aware of ~: ~을 알다
award	상, 수여하다
await	기다리다
awful	두려운, 안 좋은
baggage	수화물
balance	균형, 잔고, 균형을 잡다
bald	대머리의
bare	벌거벗은,
barren	불모의, 임신을 못하는
barrier	장벽, 장애물
barter	물물 교환하다
be based on~	~에 기초하다
bear	참다, 나르다. 마음에 품다, 아이 낳다
beard	턱수염
beg	구걸하다, 애원하다
believe	믿다
belong to ~	~에 속하다
bend	구부리다
behave	행동하다, 예의 바르게 행동하다
benefit	이익, .. 의 이익이 되다
besides	게다가
bet	내기, 내기하다, 보증하다,
betray	배반하다
bill	계산서, 청구서, 법안
bind	묶다, 구속하다
biography	전기
biology	생물학
birth	출생
bitter	쓴, 신랄한
blame	나무라다, .. 의 탓으로 돌리다
bleed	피를 흘리다
bite	물다
blend	섞다, 혼합하다
blind	눈 먼
blink	눈을 깜박이다, 깜박임
block	장애물, 블록. 막다
blond	금발인
bloom	꽃, 개화, 꽃이 피다
blow	바람이 불다, 강타
blossom	꽃, 꽃이 피다
blunder	대 실수, 실수를 범하다
blush	얼굴을 붉히다
blank	공백의, 빈
but	~을 제외하고
boast of...	..을 자랑하다
boil	끓다, 끓이다
bold	대담한
book	예약하다
border	경계, 국경선, 접경하다
botanist	식물학자
bother	괴롭히다
bounce	튀다, 바운드 시키다
bound	경계, 경계를 이루다.
bow	활, 머리를 숙이다
brand	상표, 품질
breakdown	고장, 쇠약
brief	간략한
bring about	야기하다
brilliant	훌륭한
broad	넓은
brochure	소책자
burden	짐, ..에게 짐을 지우다
burst	터지다, 파열시키다
bury	묻다
calculate	계산하다
call off	취소하다
calm	조용한, 고요한
campaign	캠페인, 운동에 참가하다
cancel	취소하다
cancer	암
candidate	입후보자
capability	능력, 가능성
capture	사로잡다
care	걱정, 근심, 돌봄, 걱정하다, 돌보다
career	경력, 직업
carve	새겨 넣다
case	경우, 사전
cash	현금, 현금으로 바꾸다
cast	던지다, 던지기
casual	우연한, 약식의
category	범주
cause	야기 시키다
caution	주의
celebrate	축하하다
certainty	확실함
charity	자비, 자선
characteristic	특징, 특징적인
charge	부담시키다, 고발하다, 짐, 부담, 요금
chat	잡담하다, 이야기하다
cheer	환호, 갈채
chemical	화학의
cherish	소중히 하다
chilly	차가운, 냉담한
choke	질식시키다, 막히게 하다
choice	선택
chop	자르다
chore	허드렛일
circulate	돌리다, 순환시키다
circumstance	상황, 처지
cheat	속이다, 바람 피우다
citizen	시민
civil	시민의, 예의 바른
claim	요구하다, 요구, 청구
classify	분류하다
clear	명확한
cling to~	~에 집착하다
clue	단서
clumsy	서투른, 솜씨 없는
collapse	붕괴하다
collide	충돌하다
comedy	희극
comfort	위안
command	명령(하다)
comment	짧은 논평, 논평하다
commerce	상업
commit	범하다
common	일반적인, 흔한
commonplace	일반적인
communicate with~	~와 의사 소통하다
community	지역 사회
company	회사, 친구
compare	비교하다
compensate	보상하다, 갚다, (for~)
compete	경쟁하다
competent	유능한, 자격이 있는
complete	완전한, 완성하다
complain	불평하다
complex	복잡한, 강박관념, 복합체
compliment	칭찬
compose	구성하다, 작곡하다
comprehend	이해하다
comprise	포함하다, 구성되다
compromise	타협하다
conceal	숨기다.
concentrate on~	~에 집중하다
concept	개념
concern	관심, 걱정, .. 에 관계하다
conclude	결론짓다
conduct	행동하다
confident	자신감 있는
confine	제한하다, 한정하다
confirm	확실히 하다, 승인하다
conflict	투쟁하다, 투쟁
confuse	혼동시키다
congratulate	축하하다
connect	연결하다, 연결되다
conquer	정복하다
conscience	양심
be conscious of~	~을 인식하다
consent	동의하다, 승낙하다
consequence	결과
conserve	보존하다
consider	고려하다, 생각하다
consist of~	~로 구성되어지다
constant	계속되는
constitute	구성하다, 조직하다
construct	건설하다
consult	.. 의 의견을 듣다, 의논하다
consume	소비하다, 낭비하다
contact	접촉, 연락하다
contain	포함하다
contaminate	오염시키다, 더럽히다
contemporary	동시대의 (사람)
content	내용물, 만족,
continue	계속하다
contract	계약하다, 수축시키다, 계약
contradict	반박하다
contrary	반대의, 모순된
contribute to ~	~에 공헌하다
control	통제(하다) 지배
convenience	편리함
cooperate	협동하다
correspond	교신하다, to ~: 에 상당하다
cost	가격, 비용이 들다
corrupt	타락한, 타락시키다
counsel	의논, 상담, 상담하다
count	계산하다, 세다, 중요성을 지니다
costly	값이 비싼
counter	계산대, 반대의
courage	용기
courtesy	예의
cover	덮다, 취재하다, 포함하다
correct	옳은, 정확한, 바로잡다
crash	충돌(하다)
create	만들다, 창조하다
convince	확신시키다 convince A of B
credit	신용, 영예, 학점
crime	범죄
crisis	위기
criticize	비평하다, 비난하다
crucial	중요한, 결정적인
crude	가공하지 않은,
cruel	잔인한
cultivate	경작하다, 재배하다
culture	문화, 재배하다, 교화하다
cure	치료하다, 치료
curious	호기심 있는
currency	화폐, 유통
custom	관습, customs 세관, 관세
cute	귀여운
cynical	냉소적인
danger	위험
deal	다루다 (with) 장사하다, 거래, 협정
debate	토론, 토론하다
deceive	속이다, 기만하다
declare	선언하다, 신고하다
decline	기울다, 떨어지다
decorate	장식하다
dedicate	헌신하다
decrease	감소, 감소하다
defect	결점, 결함,
defend	방어하다, 지지하다
define	정의를 내리다
definite	명백한
decay	썩다, 썩이다
debate	토론, 토론하다
date	날짜, 만날 약속, ... 와 데이트하다
delay	연기하다, 늦어지다, 연기
deliberate	신중한, 숙고하다
delicate	섬세한
delight	기쁨, 기쁘게 하다
curly	곱슬머리의
deliver	배달하다
demand	요구하다, 요구
demonstrate	설명하다, 증명하다, 시위하다
deny	거절하다
dense	밀집한, 조밀한
dental	치과의
depart	떠나다, 출발하다
depict	묘사하다
deplete	소모시키다, 비우다
deposit	두다, 아래에 놓다
depress	풀이 죽게하다, 불경기로 만들다
deprive	박탈하다
descend	내려가다
describe	묘사하다
desert	사막, 황무지, 버리다, 도망하다
design	설계, 설계하다, 계획
desire	바라다, 원하다, 욕망
desperate	절망적인, 필사적인
despise	경멸하다
destination	목적지
destroy	파괴하다
detail	세부, 상술하다
detect	감지하다, 발견하다
deserve	.. 할 가치가 있다, .. 될 자격이 있다
deteriorate	나쁘게 하다, 열등하게 하다,
determine	결심하다
devastate	황폐화시키다
develop	발전하다, 발전시키다
devise	고안하다, 궁리하다
devote	바치다
differ from~	~과 다르다
difficulty	어려움
digest	소화하다
dignity	위엄
dilemma	딜레마
diligent	근면한
dime	10 센트
diminish	줄다, 감소시키다
diplomacy	외교, 외교 수완
direct	감독하다, 향하게 하다, 직접의
disadvantage	불리,
disappoint	실망시키다
disaster	재난
discern	분별하다
discharge	짐을 내리다, 방출하다, 발사하다
discipline	훈련, 규율, 훈련하다
discount	할인, 할인하다
discover	발견하다
discriminate	차별하다
discuss	토론하다
disease	병
disgrace	불명예
disguise	가장, 변장, 가장하다
disgust	혐오, 혐오스럽게 하다
dispense with	.. 없이 지내다
display	전시(하다)
dispose of	..을 처분하다, 처리하다
dissimilarity	차이점, 상이점
dissolve	용해하다, 분해하다
distress	걱정, 괴롭히다
distribute	분배하다
disturb	방해하다
diverse	다양한, 각양각색의
divide	나누다
dizzy	어지러운
do without~	~없이 지내다
domestic	국내의
dominate	지배하다
donate	기부하다
double	두 배의, 두 배로, 두 배로 하다
drive	운전하다, .. 한 상태가 되게 하다
dress	옷을 입히다, 의복, 옷
district	지역
drown	익사하다
drift	표류(하다)
due	만기가 된, .. 할 예정인 due to: ~에 기인한
duty	의무, 책임, 관세
dwell	거주하다, 살다
eager	열망하는, 간절한 be eager to
earnest	성실한, 진지한, 중대한
easygoing	같이 지내기 쉬운, 태평한
ecologist	생태학자
economy	경제
effect	효과, 영향
edge	가장자리, 모서리, 강점
efficient	능률적인, 효율적인
elaborate	정성 들여 만들다, 정교한, 공들인
be dying to~	몹시 ~하고 싶어하다
electric	전기의
elect	선출하다, 선거하다
elegance	우아
be eligible for~	~할 능력이 있다
eliminate	제거하다
embarrass	당황하게 하다
embrace	포옹하다, 받아들이다
emerge	나타나다
emigrate	타국으로 이주하다
eminent	눈에 띄는
emit	발하다, 방출하다
emotion	감정
emphasis	강조(하다)
employ	고용하다
enclose	둘러싸다, 에워싸다
encounter	만나다
endanger	위험에 처하게 하다
endure	참다, 견디다
energy crisis	에너지 위기
enforce	강요하다
engage	약속하다, 종사하다
enhance	향상시키다, 높이다
enormous	막대한, 거대한
ensure	확실하게 하다
entertain	즐겁게 하다, 받아들이다
enthusiastic	열광적인
entire	전체의
be entitled to~	~할 자격을 받다
entrance	입구, 출입
envious	부러워하는
environment	환경
envy	부러워하다
epoch	신기원
be equal to~	~와 동등하다
equation	평균, 등식
equip	갖추다, 설비하다
error	실수
erupt	분출하다
be essential to~	~에 필수적이다
establish	성립하다
estimate	평가하다, 어림잡다, 견적, 판단
eternal	영구적인
ethnic	민족의, 인종의
evaluate	평가하다
evaporate	증발하다, 증발시키다
even	평평한, 짝수의 , 더욱, .. 조차
eventually	결국
evidence	증거
evolve	진화하다, 진화시키다
exaggerate	가장하다
examine	조사하다
excel	능가하다
exceptional	예외 적인
excess	초과, 과잉
exchange	교환하다
excite	흥분시키다
exclaim	소리치다, 외치다
exclude	배제하다
exercise	운동(하다)
exert	힘을 쓰다, 발휘하다
exhaust	지치게 하다
exhibit	전시하다, 전시
exotic	이국적 정취가 나는
expand	넓히다, 확장하다
expel	추방하다, 쫓아 버리다
expense	비용
experiment	실험(하다)
expert	전문가
explode	폭발하다
export	수출(하다)
expose .. to ~	..를 ~에게 노출시키다
express	표현하다, 명백한, 속달
extend	뻗다, 늘이다, 확장하다
extinct	멸종한, 불이 꺼진
ethics	윤리학
examine	조사하다
extinguish	불을 끄다
extreme	극단의, 끝의
fable	우화
face	얼굴, 직면하다
frost	서리, 서리로 덮다
fight for~	~을 위해 싸우다
facility	시설
factor	요인, 원인
fade	사라지다
fair	공정한, 살결이 흰, 박람회
faith	믿음
false	가짜의
familiar	익숙한
famine	기아
fancy	공상, 화려한, 공상하다
fantastic	환상적인, 공상적인
fascinate	매료시키다
fashion	유행, 방식
fasten	매다
fate	운명
faint	희미한, 실신하다
fatigue	피로
fault	실수
favor	호의 부탁
feature	특징
feed	먹이다
fertile	비옥한, 번식력 있는
festive	축제의, 즐거운
fever	열병
fiber	섬유(질)
fierce	흉포한, 맹렬한
figure	모양, 숫자, ..라고 생각하다 out..을 이해 하다
fill	채우다
finance	재정
fine	벌금(을 내다)
firm	굳은, 단단한, 굳게 하다
fit	꼭 맞는, 유능한, .. 에 맞다, 적합하다
fix	고치다, 고정시키다, 식사를 준비하다
flatter	아첨하다
flight	비행
float	뜨다
flow	흐르다
flu	감기
fluency	유창함
focus on~	~에 집중하다, ~에 대한 집중
fold	접다
forbid	금지하다 forbid O to R~
force	힘, 강요하다 force O to R~
fortune	운, 재산
fossil	화석
foster	기르다, 양육하다
found	설립하다
free	자유로운, 자유롭게 하다
frequency	빈번, 빈도
frighten	두려워하게 하다
frustration	좌절
fulfill	성취하다
function	기능(하다)
fundamental	기본적인
furious	화가 난
furnish ~ with ....	~에게..을 공급하다
furthermore	더군다나
fuzzy	흐린, 명확하지 않은
gain	얻다, 시간이 더가다, 증가
gallery	화랑, 미술간
gap	차이
garbage	쓰레기
gather	모으다, 모이다
gaze at~	~을 응시하다
generalize	일반화시키다
considering ~	~을 고려해보면
generate	생성하다, 낳다
generous	관대한
genetic	유전학적인
genuine	진짜의
geography	지리, 지리학
germ	세균
gesture	몸짓, 제스처
get on with~	.. 와 사이좋게 지내다
give in	제출하다, 굴복하다, 양보하다
glare	번쩍이는 빛, 현란함
global	지구의, 전 세계적인
gloomy	우울한
go through~	~을 겪다
grab	잡다, 잡기,
gradual	점진적인
graduate from~	~로부터 졸업하다
grand	웅장한, 거대한
grateful	감사하는
greenhouse effect	온실 효과
graceful	우아한
greed	욕심
grief	슬픔, 비탄
guarantee	보증, 보증하다
guide	안내하다, 안내
guilty	유죄의 be guilty of~: ~에 유죄이다
hand over	넘겨주다
handicapped	장애인의
handle	다루다, 취급하다
hardship	역경, 고난
harm	해, 손해, 상하게 하다
harmonious	조화로운
haste	급함, 신속
harsh	거친, 가혹한
hasten	서두르다, 재촉하다
heal	치료하다
heredity	유전
hesitate	망설이다. hesitate to R~: ~할 것을 망 설이다
history	역사
honor	명예, 존경하다
horizon	수평선, 지평선
horrible	끔직한, 무서운
hospitable	호의적인
hostile	적대적인
hug	껴안다, 포옹
humanity	인류, 인간성
huge	거대한
humble	겸손한
humid	습기 찬
humiliate	모멸감을 주다
humor	유머
identify	확인하다, 동일시하다
ignore	무시하다
ill-treat	냉대하다
illusion	환상
imagine	상상하다
imitate	흉내내다
immature	미숙한
immediate	즉시의, 당면한
influence	영향, 영향을 미치다
. of ~	.. 에게 ~을 알리다
ingenious	기발한, 영리한
inhabit	. 에 살다
inherit	상속하다, 유전하다
inhospitable	냉대하는
inhuman	비인간적인
injure	상처를 입히다
innocent	순진한, 죄없는
inquire	질문하다, 문의하다
insane	미친
insert	삽입하다
insight	통찰력
insist	주장하다
inspect	조사하다, 검사하다
inspire	영감을 주다 inspiration: 영감
instability	불안전성
install	설치하다
instance	예, 보기
instinct	본능, 천성
instruct	가르치다
insult	모욕, 모욕하다
intellect	지성, 지력
intelligence	지성, 지혜
intend to R~	~할 것을 의도하다
intense	강렬한
interest	이자, 관심
interfere with~	~를 방해하다
internal	내부의
interpret	해석하다
interrupt	방해하다, 중단시키다
intimate	친밀한
intolerable	참을 수 없는
invade	침입하다
invaluable	소중한
invent	발명하다
invest	투자하다
investigate	조사하다
involve	포함하다, 필요로 하다
ironical	비꼬는, 풍자적인
irresistible	저항할 수 없는
irritate	짜증나게 하다
isolate	고립시키다
issue	발행하다, 유포시키다, 발행, 발행물
itchy	가려운
be jealous of~	~을 질투하다
join	참가하다, 합쳐지다,
journalist	언론인
judge	판단하다, 판단
justice	정의
be keen on~	~에 열중이다
key	열쇠, 실마리
lack	부족, ~이 없다
tame	길들이다
land	땅, 착륙하다
landscape	풍경
language	언어
last	지속하다, 맨 마지막의
lately	최근에
laundry	세탁소, 세탁물
lay	놓다
lead	이끌다, 주도, lead to~: ~의 원인이 되다
leak	새다
lean	기대다, 기울이다
leave out	생략하다
legal	합법적인
length	길이
lessen	줄이다
let down	실망시키다
liberal	자유주의의, 자유로운
lift	올리다
likelihood	가능성, 가망
likewise	마찬가지로
limit	제한(하다)
liquid	액체(의)
list	목록(으로 만들다)
literature	문학
local	지역의
locate	위치하다, 찾아내다 be located in~
lock	잠그다
log	통나무, 항해 일지
logic	논리(학)
lonely	외로운
long for~	~을 바라다
long-term	장기간의
look up to~	~를 존경하다
loose	느슨한, 풀다, 끄르다
lose	잃다, 지다
lottery	복권, 추첨
lower	낮추다
loyal	충성스러운, 성실한
lure	미끼, 유혹하다
luxurious	사치스러운, 사치를 좋아하는
magnificent	장엄한, 웅장한, 엄청난
magnify	확대하다
main	주요한
maintain	유지하다
major	주요한, 대부분의, 성인, 전공 과목, 소령
malnutrition	영양 실조
management	경영, 관리, 취급
manufacture	제조하다
marvel	경이, 놀라운 일
mass	덩어리, 모임, 집합시키다, 미사
master	주인, 교사, 대가, 정복하다, 숙달하다
masterpiece	걸작
masterpiece	걸작
material	물질의, 재료, 자료
matter	문제, 중요하다
mature	성숙한
maximum	최대
measure	평가하다, 치수
mechanic	(자동차) 수리공
medical	의학의
meditate	명상하다
medium	매개, 중간의
meet	만나다, 만족시키다
melt	녹다, 녹이다
memorize	암기하다
mend	수리하다, 고치다
mental	정신의
mention	언급하다
merchant	상인
merciful	자비로운
mere	단순한, 순전한
merit	장점
mess	혼란, 더러움
metal	금속의
method	방법
migrate	이주하다
minor	중요하지 않은, 미성년자
mischief	해악, 손해, 악의 없는 장난
misdeed	악행, 비행
miserable	불쌍한, 비참한
military	군대의, 군대
minus	마이너스의, 영하의
misfortune	불행
miss	놓치다, 그리워하다
misunderstand	오해하다
misuse	오용하다
mix	혼합하다, 섞다
moderate	알맞은, 적당한
modern	현대의
modest	겸손한
modify	바꾸다
mold	주형, 틀, 주조하다
molecule	분자
momentary	순간의, 잠시 동안의
monotonous	단조로운, 지루한
monster	괴물
moral	도덕의
mortal	죽을 운명의, 치명적인
motivation	동기
mourn	애도하다
muddy	진흙의
mumble	중얼거리다, 중얼거림
moist	습기, 습기에 젖은
murder	살인, 살해하다
muscle	근육
mutual	상호의, 서로의
mystery	신비, 비밀
mythology	신화
naive	순진한, 소박한
naked	벌거벗은
narrow	좁은
native	원주민의, 자국의
natural	자연의, 천부의, 당연한
naughty	장난의, 버릇없는
navigate	항해하다
necessary	필요한
negative	부정적인
neglect	소홀히 하다
negotiate	협상하다
nerve	신경, 용기
neutral	중립의
noble	고상한, 신분이 높은
note	각서, 메모, 적어두다
nourish	자양분을 주다, 기르다
nuclear	핵의, 핵무기
numerous	다수의, 매우 많은
nurture	양육, 양육하다
nutrition	영양
obey	순종하다, 복종하다
object	반대하다
obscure	흐린, 모호한
observe	지키다, 관찰하다
obstinate	고집 센
obtain	얻다, 획득하다
obvious	명확한
occasional	때때로의,
occupation	직업
occupy	차지하다
occur	일어나다 occur to~: ~에게 생각나다
odd	이상한, 홀수의
offend	불쾌하게 하다, 위반하다
offer	제공(하다)
omit	생략하다
operation	운전, 수술
opinion	의견
opportunity	기회
oppress	압박하다
optimism	낙천주의
oral	구두의, 입의
ordinary	평상의, 보통의
organize	조직하다, 편성하다
origin	기원
outstanding	눈에 띄는
overcome	극복하다
overdue	기한이 지난, 늦은
overhear	엿듣다,
overlook	간과하다
overnight	밤사이에, 하룻밤 사이의
over-population	과잉 인구
over-simplification	지나친 단순화
overtake	따라 잡다
overthrow	뒤집어엎다, 전복시키다, 전복
overweight	비만의, 뚱뚱한
overwhelm	압도하다
owe .. to ~	.. ..을 ~에게 빚지다
panic	공황
pant	헐떡이다
parcel	소포
part	부분, 헤어지다
participate	참가하다
passion	정열
passive	수동적인
pastime	오락
pat	두드리다
patience	인내
pattern	패턴, 유형
pay	지불하다, 이익이 되다, 임금
peculiar	특별한, 독특한
pain	고통
piece	조각, 부분, 파편
particular	특별한
penniless	무일푼의
penalize	유죄를 선고하다
perceive	자각하다, 인지하다
perform	실행하다, 공연하다
peril	위험
perish	멸망하다, 소멸하다
permanent	영구적인
permission	허가, 허용
persist	고집하다, 주장하다
phase	단계, 국면, 양상
phenomenon	현상
physical	육체의, 물질의
picture	그림, 그리다, 상상하다
pierce	꿰뚫다, 관통하다, 구멍을 내다
pitiful	가엾은, 불쌍한
plain	평범한, 보통의, 예쁘지 않은
plead	애원하다
plus	..을 더하여
poem	시
point	점, 핵심, 지적하다(out)
poison	독
political	정치의,
poll	여론조사
pollute	오염시키다
popularity	인기, 평판
population	인구
portable	휴대할 수 있는
portion	일부, 한 조각
portrait	초상화,
pose	자세, 태도, 포즈를 취하다
position	입장, 위치, 지위
positive	긍정적인
possess	소유하다
possibility	가능성
post	기둥, 붙이다, 우편, 지위
postpone	연기하다
potency	잠재력, 효능
pour	쏟다, 퍼붓다
poverty	가난
practice	연습(하다), 관습, 실행하다
precaution	조심, 경계
precede	앞서다, 선행하다
precious	소중한
precise	정확한, 정밀한
predict	예언하다
prefer	선호하다
prejudice	선입견
prepare	준비하다
prescribe	규정하다, 처방하다
present	선물, 현재의, 출석한, 주다
preserve	보존하다, 보관하다
presidency	대통령의 지위
pressure	압력
pretend	.. 인 체하다, 흉내를 내다
prevail	우세하다, 보급되다
prevent	막다, 예방하다
previous	전의, 과거의
price	가격
prime	첫째의, 주요한, 청춘의, 전성기
primitive	원시적인, 원시의
principal	주요한, 교장
principle	원리, 원칙
priority	우선권
privacy	사생활
privilege	특권
probably	아마도
proceed	나아가다, 전진하다
produce	생산하다
profit	이익, 소득, 이익을 보다
progress	전진, 진보, 전진하다, 향상하다
prohibit	금지시키다
project	계획(하다)
prolong	늘이다, 연장하다
promise	약속, 장래성
promote	승진시키다, 장려하다
prompt	신속한, 민첩한
pronounce	발음하다
proof	증거
proper	적절한, 알맞은
property	재산, 특성
proportion	비율
proposal	제안, 청혼
prospect	전망
prosper	번영하다
protect	보호하다
protein	단백질
protest	항의(하다)
proverb	속담
psychological	심리적인, 심리학의
publish	출판하다
pulse	맥박, 진동, 맥이 뛰다
punctual	시간을 어기지 않는
punish	처벌하다
purchase	구입(하다)
pure	순수한
purpose	목적
pursue	추구하다, 수행하다
puzzle	수수께끼, 당황하게 하다
qualify	자격을 주다
quality	질
quantity	양
questionnaire	설문지
quotation	인용
race	경주, 인종
radiate	빛이 (발하다)
rage	분노, 격노
rain forest	열대 우림
raise	기르다, 제기하다, 임금 인상
range	범위, 정렬시키다, ..의 범위까지 이르다
rank	순위, 지위, 등급을 짓다
rapid	빠른
rarely	드물게, 좀처럼... 않다
rate	비율, 요금, 평가하다
rather	오히려, 다소
rational	이성적인
raw	날 것의, 가공하지 않은
reach	도달하다, 도착하다
react to~	~에 반응하다
realistic	현실적인
realize	깨닫다, 실현하다
reap	베다, 수확하다
rear	뒤, 뒤의, 기르다
rearrange	재배치하다
reason	이유, 원인, 추론하다
recall	소환하다, ..을 생각나게 하다, 소환
receipt	영수증
recall	소환하다
recent	최근의
reception	받아들임, 수령
recipe	처방, 조리법
recognize	인정하다, 인식하다
recommendation	추천
recover	회복하다
recycle	재생하여 이용하다
reduce	줄이다
reflect	반영하다, 반사하다, 곰곰이 생각하다
reform	개혁(하다)
refrain from~	~을 꺼리다
refund	환불
refuse	거부하다,
regain	되찾다, 회복하다
region	지역
regret	후회(하다)
regular	규칙적인, 보통의, 단골
reject	거절하다
relate	관계시키다, 이야기하다
relax	긴장을 풀다, 늦추다
release	풀어놓다, 개봉하다, 방출하다
reliable	믿을 수 있는
relic	유적, 유물
relieve	구원하다, 경감하다
religious	종교적인, 독실한
be reluctant to~	~하는 것을 꺼리다
remark	말하다, 주의, 비평
remember	기억하다
remind A of B	A에게 B를 생각나게 하다
remote	멀리 떨어 진
remove	제거하다, 치우다
render	.. 이 되게 하다, 제출하다, 보내다
renew	갱신하다, 새롭게 하다
rent	집세, 빌리다
repair	수리(하다)
repeat	반복하다
repent	후회하다
replace	대체하다, 대신하다
reply	응답하다 (to)
represent	묘사하다, 대표하다
reproduce	재생하다, 재현하다
reputation	명성
request	요구(하다)
require	요구하다, 필요로 하다
rescue	구조(하다)
research	연구(하다)
resemble	닮다
resent	분개하다, 화내다
reservation	예약
reside	살다, 거주하다
resign	사임하다
resist	저항하다
resolve	결심하다, 풀다
resort	유흥지, 의지(하다)
resource	원천, 자원
respect	존경(하다)
respond to~	~에 반응하다
restore	반환하다, 되찾다
restrain	억누르다, 제지하다
restrict	제한하다, 금지하다
resume	재개하다
retain	보유하다, 계속 지니다
retire	은퇴하다
reveal	드러내다, 폭로하다
revenge	복수(하다)
revise	교정하다
revolution	혁명
reward	보상, 보수, ...에게 보답하다
ridicule	비웃음, 비웃다
rigid	엄격한, 단단한
ripe	익은, 여문
risk	위험, 위험을 무릅쓰고 ... 하다
rival	경쟁자
rob A of B	A에게 B를 훔치다
role	역할
rotten	썩은
rough	거친, 험악한
routine	일상 업무, 판에 박힌 일
row	열, 줄, 노로 배를 젓다, 소동
royal	왕의, 훌륭한
rub	문지르다
rub	문지르다
ruin	파괴하다
ruler	자, 통치자
rural	시골의
rush	돌진하다, 달려들다, 돌진, 쇄도
scared	깜짝 놀란
sacrifice	희생
safety	안전
sane	제정신의
scarcity	부족, 결핍
scatter	뿌리다, 흩뜨리다, 분산하다
scene	장면, 야단법석
scent	향기, 냄새
schedule	일정표, 시간표, 예정하다
scold	꾸짖다
scream	외치다, 비명
search	탐색하다, 탐색
secure	확실한, 안전하게 하다, 보증하다
seek	찾다, 구하다
seize	붙잡다, 꼭 쥐다
select	선택하다
self-confident	자신감 있는
senior	손위의, 연장자
sense	감각, 오감, 느끼다, 깨닫다
separate	분리시키다, 별개의
sentimental	감상적인
sequence	연속,
series	일련, 연속
serve	음식을 차려내다, 섬기다, 도움이 되다
set	놓다, 되게 하다
settle	정착하다
severe	심한
shake	흔들다, 흔들리다
shape	모양
share	할당, 몫, 나누다
shift	이동시키다, 이동하다, 이동, 근무시간
shortage	부족, 결핍
show off~	~을 과시하다, 자랑하다
shrink	줄어들다,
shrug	어깨를 으쓱하다
side effect	부작용
sigh	한숨(쉬다)
sight	시각, 경치
sign	기호, 간판, 서명하다
significant	중요한
similar	비슷한
simple	간단한, 검소한, 수수한
sincere	성실한, 진지한
sink	가라앉다
skip	건너뛰다
slam	꽝 닫다,
soar	치솟다, 높이 솟다
social	사회적인, 친목의
soil	흙
sore	아픈,
solitary	고독한, 혼자의
solution	해결
sorrow	슬픔
sound	건전한, 소리
sow	씨를 뿌리다,
spare	아끼다, 여분의, 남는
sparkle	불꽃, 불꽃을 튀기다
specialize	전문화하다
species	종
specific	특수한
spectacle	광경, 장관
spill	엎지르다
spirit	정신, 독한 술
splendid	찬란한, 근사한
spoil	망쳐놓다, 손상하다
spread	벌리다, 뻗다
squeeze	짜내다, 짜기
stab	찌르다
stability	안정, 부동
stage	단계, 국면, 무대에 올리다
stare at~	~을 응시하다
startle	깜짝 놀라게 하다
starvation	기아
statistics	통계
status	지위
stillness	고요함
steady	꾸준한
steep	가파른
stick	막대기, 찌르다
stimulate	자극하다
sting	찌르다
stir	휘젓다
store	가게, 저장하다
survival	생존
stuff	물질, 잡동사니, 채우다
strength	힘
strict	엄격한
subconscious	잠재의식의
be subject to~	~하기 쉽다
subtract	빼다
supply	공급(하다)
substance	물질, 실체
subtle	미묘한
suffer from~	~로 고생하다
suitable	적당한
superficial	피상적인
superstition	미신
supplement	보충
suppose	생각하다, 가정하다
surround	둘러싸다
suspect	의심하다, 혐의자
suspend	중지하다, 연기하다
sustain	유지하다, 떠받치다
symbolize	상징하다
sympathetic	동정적인
tame	길들이다, 길든
task	임무, 할 일
tear	눈물, 찢다
tease	놀리다
temper	기질, 천성
technology	기술
temperate	기온이 온화한
temperature	기온
temporary	일시적인, 잠정적인
tourist attraction	관광명소
tempt	유혹하다
term	기간, 조건, 용어,
tendency	경향
tender	부드러운, 부드럽게 하다
tense	긴장된, 팽팽한
terrible	무서운, 무시무시한
terrify	겁나게 하다
terrify	겁나게 하다
testify	증명하다, 증언하다
threat	위협
thrift	겸손한
thrilling	오싹하게 하는
thrive	번영하다
tidy	말쑥한, 깔끔한
timid	소심한
tip	끝, 기울이다, 조언, 정보, 팁을 주다
tolerate	참다
tough	거친, 힘든
totally	완전히, 전부
traditional	전통의
tragedy	비극
transfer	이동하다, 옮기다
transform	변형시키다, 바꾸다
transparent	투명한
tremendous	엄청난
transplant	이식하다
treat	취급하다, 다루다, 대접(하다), 치료하다
tremble	떨다, 전율하다
trend	경향
tribe	부족
trim	손질하다, 다듬다
triple	세배의, 세배로 하다
trivial	사소한
tropical	열대 지방의
trouble	문제, 괴롭히다
turn	돌다, 차례
typical	전형적인
ultimate	궁극적인
uncover	폭로하다
underestimate	과소 평가하다
undergo	겪다, 견디다, 참다
underline	강조하다
understand	이해하다
undertake	떠맡다
unemployment	실업
unique	독특한, 유일한
universal	보편적인, 일반적인
unusual	정상이 아닌, 예외적인
upset	화나게 하다, 화난
urban	도시의
urgency	긴급
vacancy	공허, 빈 상태
vague	모호한
vain	공허한
valuable	소중한
vapor	증기, 증발시키다
vary	다양하게 하다, 바꾸다, 다양하다
vegetable	채소
vehicle	차량, 탈것, 매개물
victim	희생자
violate	위반하다
violence	폭력
virtue	미덕, 덕
visible	볼 수 있는
vivid	생생한
volcano	화산
voluntary	자발적인
volunteer.	자원자, 자원하다
vote	투표(하다)
yield	생산(하다), 양보하다, 굴복하다
